0,0,0,0,0,0,5,5,0,0,0,0,0,0
0,0,0,288,88,777,233,0,0,0,0,0,0,0
0,0,0,0,205,778,779,329,0,6,0,0,0,0
0,4,0,0,0,0,0,0,0,0,404,0,0,0
0,0,7,0,363,153,0,0,0,0,0,405,0,0
0,0,0,90,3,780,406,0,0,0,0,0,0,0
0,0,0,407,92,0,408,81,0,0,0,0,0,0
0,0,0,155,409,70,0,0,0,0,0,0,0,0
0,0,0,0,157,70,0,0,0,0,0,0,0,0
0,0,0,107,3,781,162,162,0,0,0,0,0,0
0,0,0,0,149,129,366,164,165,0,0,0,0,0
0,0,0,0,0,241,133,134,17,18,0,0,0,0
0,0,0,0,0,0,243,136,20,58,0,0,0,0
0,0,0,0,0,0,0,0,0,0,0,0,0,0
