0,0,0,0,87,87,87,87,87,87,87,87,87,87,87,87,87,87,87,87,87,87,87,87,87,87,87,87,87,87,87,87,87,87,87,87,87,87,87,87,87,87,0,0
0,0,0,0,88,0,0,0,0,0,0,0,0,0,0,0,0,0,0,0,0,0,0,0,0,0,0,0,0,0,0,0,0,0,0,0,0,0,0,0,0,0,96,0
0,0,0,0,88,0,0,0,0,0,0,0,0,0,0,0,0,0,0,0,0,0,0,0,0,0,0,0,0,0,0,0,0,0,0,0,0,0,0,0,0,0,96,0
0,0,0,0,88,0,0,0,0,0,0,0,0,0,0,0,0,0,0,0,0,0,0,0,0,0,0,0,0,0,0,0,0,0,0,0,0,0,0,0,0,0,96,0
0,0,0,0,88,0,0,0,0,0,0,0,0,0,0,0,0,0,0,0,0,0,0,0,0,0,0,0,0,0,0,0,0,0,0,0,0,0,0,0,0,0,96,0
0,0,0,0,88,0,0,0,0,0,0,0,0,0,0,0,0,0,0,0,0,0,0,0,0,0,0,0,0,0,0,0,0,0,0,0,0,0,0,0,0,0,96,0
0,0,0,0,88,0,0,0,0,0,0,0,0,0,0,0,0,0,0,0,0,0,0,0,0,0,0,0,0,0,0,0,0,0,0,0,0,0,0,0,0,0,96,0
0,0,0,0,88,0,0,0,0,0,0,0,0,0,0,0,0,0,0,0,0,0,0,0,0,0,0,0,0,0,0,0,0,0,0,0,0,0,0,0,0,0,96,0
0,0,0,0,88,0,0,0,0,0,0,0,0,0,0,0,0,0,0,0,0,0,0,0,0,0,0,0,0,0,0,0,0,0,0,0,0,0,0,0,0,0,96,0
0,0,0,0,88,0,0,0,0,0,0,0,0,0,0,0,0,0,0,0,0,0,0,0,0,0,0,0,0,0,0,0,0,0,0,0,0,0,0,0,0,0,96,0
0,0,0,0,88,0,0,0,0,0,0,0,0,0,0,0,0,0,0,0,0,0,0,0,0,0,0,0,0,0,0,0,0,0,0,0,0,0,0,0,0,0,96,0
0,0,0,0,88,0,0,0,0,0,0,0,0,0,0,0,0,0,0,0,0,0,0,0,0,0,0,0,0,0,0,0,0,0,0,0,0,33,33,33,33,0,96,0
0,0,0,0,88,0,0,0,0,0,0,0,0,0,0,0,0,0,0,0,0,0,0,0,0,0,0,0,0,0,0,0,0,0,0,0,0,395,299,299,299,96,96,0
0,0,0,0,88,0,0,0,0,0,0,0,0,0,0,0,0,0,0,0,0,0,0,760,760,0,0,0,0,0,0,33,33,33,33,33,33,174,0,0,0,173,87,0
0,0,0,0,88,0,0,0,0,0,0,0,0,0,0,0,0,0,0,0,0,0,0,761,762,763,0,0,0,0,0,395,764,764,764,764,764,764,0,0,0,0,0,96
0,0,0,33,368,33,33,33,33,33,33,33,33,0,0,0,0,0,0,0,0,0,0,765,766,767,33,33,33,33,33,174,768,31,31,31,31,31,46,0,0,147,147,96
0,0,0,88,299,299,299,299,299,299,299,299,299,0,0,0,0,0,0,0,0,0,0,761,762,395,299,299,299,299,299,299,27,29,29,29,29,29,47,48,0,96,0,0
0,87,87,88,0,0,0,0,0,0,0,0,0,33,300,33,33,33,33,33,33,33,33,769,770,174,0,0,0,0,0,0,54,55,56,57,57,57,49,132,50,96,0,0
0,88,0,0,0,0,0,0,0,0,0,0,0,39,39,299,299,299,299,299,299,299,299,299,299,0,0,0,0,0,0,0,100,101,142,133,133,133,60,132,72,96,0,0
0,191,147,0,0,0,0,0,0,0,0,0,0,0,0,0,0,0,0,0,0,0,0,100,100,100,100,100,100,100,100,100,301,108,180,134,134,134,135,136,72,96,0,0
0,0,0,88,0,0,0,0,0,0,0,0,0,0,0,0,0,0,0,0,0,0,0,301,108,108,108,108,108,108,108,108,108,180,134,134,134,134,64,65,0,96,0,0
0,0,0,88,0,0,0,0,0,0,0,0,0,0,0,0,0,0,0,0,0,0,0,301,180,134,134,134,134,134,134,134,134,134,134,134,134,134,64,65,0,96,0,0
0,0,0,88,0,0,0,0,0,0,0,0,0,0,0,0,0,0,0,0,0,0,0,301,180,134,134,134,134,134,134,134,66,66,66,66,66,66,64,65,0,96,0,0
0,0,0,88,0,100,100,100,100,100,100,100,100,100,100,100,100,0,0,0,0,0,0,301,180,134,134,134,134,134,134,134,64,67,67,67,67,67,67,65,0,96,0,0
0,0,0,191,147,301,108,108,108,108,108,108,108,108,108,108,108,102,0,0,0,0,0,103,104,66,66,66,66,66,66,66,64,65,0,0,0,0,0,0,0,96,0,0
0,0,0,0,0,301,180,134,134,134,134,134,134,134,134,134,134,64,65,0,0,0,0,0,106,67,67,67,67,67,67,67,67,65,0,0,0,0,0,147,147,96,0,0
0,0,0,0,0,301,180,134,134,134,134,134,134,134,134,134,134,64,65,0,0,0,0,0,0,0,0,0,0,0,0,0,0,0,0,0,0,0,0,96,0,0,0,0
0,0,0,0,0,301,180,134,134,134,134,771,771,771,771,771,771,64,65,0,0,0,0,0,0,0,0,0,0,0,0,147,147,147,147,147,147,147,147,96,0,0,0,0
0,0,0,0,0,301,180,134,134,134,134,772,773,774,775,776,143,566,65,0,0,0,0,0,0,0,0,0,0,0,0,96,0,0,0,0,0,0,0,0,0,0,0,0
0,0,0,0,0,301,180,134,134,134,134,777,302,303,304,305,306,563,72,0,0,0,0,0,0,0,0,0,0,147,147,96,0,0,0,0,0,0,0,0,0,0,0,0
0,0,0,0,0,301,180,134,134,134,134,307,308,309,310,311,312,313,72,0,0,0,0,0,0,0,0,0,0,96,0,0,0,0,0,0,0,0,0,0,0,0,0,0
0,0,0,0,0,301,180,134,134,134,134,24,778,314,315,316,317,318,424,0,0,0,0,0,0,0,0,0,0,96,0,0,0,0,0,0,0,0,0,0,0,0,0,0
0,0,0,0,0,301,180,134,134,134,134,24,779,319,320,321,322,323,780,0,0,0,0,0,0,0,0,0,0,96,0,0,0,0,0,0,0,0,0,0,0,0,0,0
0,0,0,0,0,301,180,134,134,134,134,24,26,324,325,326,327,328,329,0,0,0,0,0,0,0,0,0,0,96,0,0,0,0,0,0,0,0,0,0,0,0,0,0
0,0,0,0,0,301,180,134,134,134,134,24,26,563,330,331,332,333,0,0,0,0,0,0,0,0,0,0,0,96,0,0,0,0,0,0,0,0,0,0,0,0,0,0
0,0,0,0,0,103,104,66,66,66,66,36,57,563,72,0,0,0,0,0,0,0,0,0,0,0,0,0,0,96,0,0,0,0,0,0,0,0,0,0,0,0,0,0
0,0,0,0,0,88,106,67,67,67,67,67,109,136,72,0,0,0,0,0,0,0,0,0,0,166,166,0,0,96,0,0,0,0,0,0,0,0,0,0,0,0,0,0
0,0,0,0,0,88,0,0,0,0,0,0,0,0,0,0,0,0,0,0,0,0,0,0,166,54,190,46,0,96,0,0,0,0,0,0,0,0,0,0,0,0,0,0
0,0,0,0,0,781,140,140,140,140,140,140,0,0,0,0,0,0,0,0,0,0,0,0,54,46,58,137,48,96,0,0,0,0,0,0,0,0,0,0,0,0,0,0
0,0,0,0,0,334,0,0,0,0,0,0,186,140,140,140,140,0,0,0,0,0,0,0,0,782,48,62,335,72,0,0,0,0,0,0,0,0,0,0,0,0,0,0
0,0,0,0,0,0,93,0,0,0,0,0,334,0,0,0,0,184,0,0,0,0,0,0,0,27,783,72,0,0,0,0,0,0,0,0,0,0,0,0,0,0,0,0
0,0,0,0,0,0,0,0,0,0,0,0,0,93,0,0,0,184,0,0,0,0,0,0,0,54,47,71,0,0,0,0,0,0,0,0,0,0,0,0,0,0,0,0
0,0,0,0,0,0,0,334,0,0,0,0,0,0,336,0,0,186,140,140,140,0,0,0,0,0,58,337,72,0,0,0,0,0,0,0,0,0,0,0,0,0,0,0
0,0,0,0,0,0,0,0,93,0,0,0,0,0,334,0,0,334,0,0,0,0,0,0,0,0,0,62,50,0,0,99,99,0,0,0,0,0,0,0,0,0,0,0
0,0,0,0,0,0,0,0,0,0,0,23,23,23,23,93,0,0,93,0,0,0,210,35,140,140,140,338,0,0,0,0,0,96,0,0,0,0,0,0,0,0,0,0
0,0,0,0,0,0,0,0,0,334,0,36,143,143,143,339,784,23,23,336,0,0,0,785,217,0,0,0,0,99,0,0,0,0,0,0,0,0,0,0,0,0,0,0
0,0,0,0,0,0,0,0,0,0,93,0,786,26,26,26,0,339,339,787,0,0,0,210,340,34,99,99,0,341,338,0,0,0,0,0,0,0,0,0,0,0,0,0
0,0,0,0,0,0,0,0,0,0,0,0,27,29,26,26,342,0,0,0,93,0,0,0,785,785,341,140,338,0,0,0,0,0,0,0,0,0,0,0,0,0,0,0
0,0,0,0,0,0,0,0,0,0,0,0,27,29,28,26,342,0,0,0,334,0,0,0,210,340,290,0,0,0,0,0,0,0,0,99,99,0,0,0,0,0,0,0
0,0,0,0,0,0,0,0,0,0,0,0,54,55,56,57,788,133,133,133,133,789,178,178,178,785,785,343,0,0,0,0,0,0,0,0,0,96,0,0,0,0,0,0
0,0,0,0,0,0,0,0,0,0,0,0,0,101,142,133,133,145,134,134,134,134,134,134,134,210,340,290,344,0,0,140,338,0,0,0,0,96,0,0,0,0,0,0
0,0,0,0,0,0,0,0,0,0,0,0,0,103,104,66,66,66,66,66,66,66,66,66,66,0,785,785,344,341,140,338,0,0,99,0,0,96,0,0,0,0,0,0
0,0,0,0,0,0,0,0,0,0,0,0,0,88,106,67,67,67,67,67,67,67,67,67,67,67,210,340,290,11,74,0,0,99,0,0,0,96,0,0,0,0,0,0
0,0,0,0,0,0,0,0,0,0,0,0,0,191,147,147,147,0,0,0,0,0,0,0,0,0,0,785,785,344,11,433,99,0,0,0,0,96,0,0,0,0,0,0
0,0,0,0,0,0,0,0,0,0,0,0,0,0,0,0,0,88,0,0,0,0,0,0,0,0,0,790,345,388,11,98,0,0,0,0,0,96,0,0,0,0,0,0
0,0,0,0,0,0,0,0,0,0,0,0,0,0,0,0,0,191,147,147,147,0,0,0,0,0,0,210,340,388,11,98,0,0,0,0,0,96,0,0,0,0,0,0
0,0,0,0,0,0,0,0,0,0,0,0,0,0,0,0,0,0,0,0,100,791,0,0,0,0,0,0,785,293,11,98,0,0,0,147,147,96,0,0,0,0,0,0
0,0,0,0,0,0,0,0,0,0,0,0,0,0,0,0,0,0,0,0,145,108,369,0,0,0,0,0,790,346,220,98,0,0,0,96,0,0,0,0,0,0,0,0
0,0,0,0,0,0,0,0,0,0,0,0,0,0,0,0,0,0,0,0,146,66,64,65,0,0,0,0,210,347,220,98,0,0,0,96,0,0,0,0,0,0,0,0
0,0,0,0,0,0,0,0,0,0,0,0,0,0,0,0,0,0,0,0,0,110,67,370,0,0,0,0,0,293,348,98,0,0,0,96,0,0,0,0,0,0,0,0
0,0,0,0,0,0,0,0,0,0,0,0,0,0,0,0,0,0,0,0,0,0,0,191,147,147,147,147,147,0,0,147,147,147,147,96,0,0,0,0,0,0,0,0
0,0,0,0,0,0,0,0,0,0,0,0,0,0,0,0,0,0,0,0,0,0,0,0,0,0,0,0,0,88,0,96,0,0,0,0,0,0,0,0,0,0,0,0
0,0,0,0,0,0,0,0,0,0,0,0,0,0,0,0,0,0,0,0,0,0,0,0,0,0,0,0,0,191,147,96,0,0,0,0,0,0,0,0,0,0,0,0
0,0,0,0,0,0,0,0,0,0,0,0,0,0,0,0,0,0,0,0,0,0,0,0,0,0,0,0,0,0,0,0,0,0,0,0,0,0,0,0,0,0,0,0
