0,0,0,0,0,0,0,0,0,0,0,0,0,0,0
185,6,5,8,8,5,9,15,0,0,0,0,0,0,0
102,106,9,7,6,44,6,8,18,0,0,0,0,0,0
16,103,144,8,5,9,9,8,5,15,0,0,0,0,0
128,127,125,147,5,6,8,22,44,726,18,0,0,0,0
102,213,215,145,149,717,975,5,21,6,44,15,0,0,0
39,103,91,162,148,0,600,139,717,443,730,730,0,0,0
0,40,125,87,17,0,600,139,647,0,0,0,0,0,0
0,0,41,145,214,0,600,139,647,0,0,0,0,0,0
0,0,0,40,148,0,600,139,647,0,0,0,0,0,0
0,0,0,0,71,0,39,139,647,0,0,0,0,0,0
0,0,0,0,0,0,0,42,647,0,0,0,0,0,0
