0,0,1,0,1,1,0,432,1,0,0,0,0,0,0,0
0,0,0,210,175,3,765,0,433,211,0,0,0,0,0,0
0,0,7,212,766,0,146,213,176,435,214,0,0,0,0,0
0,0,0,0,215,216,0,158,0,269,767,217,0,0,0,0
0,0,0,0,25,215,161,14,0,0,0,0,0,0,0,0
0,0,7,218,0,28,163,164,0,0,0,0,0,21,0,0
0,0,7,768,0,0,0,0,0,0,0,0,0,21,0,0
0,0,0,0,769,0,0,219,219,0,0,0,0,64,26,0
0,0,0,0,0,0,0,220,221,222,0,0,0,29,29,21
0,0,0,0,0,338,0,223,224,225,431,0,0,21,0,0
0,0,0,0,0,0,770,29,771,772,773,29,29,21,0,0
0,0,0,0,0,0,0,0,0,0,0,0,0,0,0,0
