0,0,88,0,0,0,0,0,0,0,0,0,0,0,0,0,0,0,0,0,0,0,0,0,0,0,0,0,0,0,0,0,0,0,0,0,0,0,0,0,0,0,0,0,0,0,0,0,0,0,0,0,0,0,0
0,0,88,0,0,0,0,0,0,0,0,0,0,0,0,0,0,0,0,0,0,0,0,0,0,0,0,0,0,0,0,0,0,0,0,0,0,0,0,0,0,0,0,0,0,0,0,0,0,0,0,0,0,0,0
0,0,88,0,0,0,0,0,0,0,0,0,0,0,0,0,0,0,0,87,87,0,0,0,0,0,0,0,0,0,0,0,0,0,0,0,0,0,0,0,0,0,0,0,0,0,0,0,0,0,0,0,0,0,0
0,0,88,0,0,0,0,0,0,0,0,0,0,0,0,0,0,0,0,88,0,96,0,0,0,0,0,0,0,0,0,0,0,0,0,0,0,0,0,0,0,0,0,0,0,0,0,0,0,0,0,0,0,0,0
87,87,88,0,0,0,0,0,0,0,0,0,0,0,0,0,0,0,0,88,0,96,0,0,0,0,0,0,0,0,0,0,0,0,0,0,0,0,0,0,0,0,0,0,0,0,0,0,0,0,0,0,0,0,0
0,0,0,0,0,0,0,0,87,87,87,87,87,87,87,87,87,87,87,645,646,173,87,87,87,87,87,87,87,87,87,87,87,87,87,87,87,0,0,0,0,0,0,0,0,0,0,0,0,0,0,0,0,0,0
0,0,0,0,0,0,0,0,0,0,0,0,0,0,0,0,0,0,0,647,646,612,0,0,0,0,0,0,0,0,0,0,0,0,0,0,0,0,0,0,0,0,0,0,0,0,0,0,0,0,0,0,0,0,0
0,0,0,0,0,0,0,0,0,0,0,0,0,0,0,0,0,0,0,647,648,612,613,0,0,0,0,0,0,0,0,0,0,0,0,0,0,0,0,0,0,0,0,0,0,0,0,0,0,0,0,0,0,0,0
0,0,0,0,0,0,0,0,0,0,0,0,0,0,0,0,0,0,0,647,648,649,613,614,0,0,0,0,0,0,0,0,0,0,0,0,0,0,0,0,0,0,0,0,0,0,0,0,0,0,0,0,0,0,0
0,0,0,0,0,0,0,0,0,0,0,0,0,0,0,0,0,0,0,647,648,649,650,614,613,0,0,0,0,0,0,0,0,0,0,0,0,0,0,0,0,0,0,0,0,0,0,0,0,0,0,0,0,0,0
0,0,0,0,0,0,0,0,0,0,0,0,0,0,0,0,0,0,0,647,648,649,650,651,613,614,0,0,0,1,1,1,1,1,1,1,1,1,1,1,0,0,0,0,0,0,0,0,0,0,0,0,0,0,0
0,0,0,0,0,0,88,0,0,0,0,0,0,0,0,0,0,0,0,647,648,649,650,651,650,614,613,0,0,652,14,14,14,14,14,14,14,14,14,14,238,0,0,0,0,0,0,0,0,0,0,0,0,0,0
0,0,0,0,0,0,88,0,0,0,0,0,0,0,0,0,0,0,0,239,240,649,653,654,655,651,613,614,0,241,656,16,16,16,16,16,16,16,16,16,238,9,0,0,0,0,0,0,0,0,0,0,0,0,0
0,0,0,0,0,0,88,0,0,0,0,0,0,0,0,0,0,0,0,0,242,243,657,658,659,660,655,614,613,0,661,662,17,17,17,663,17,17,17,17,17,244,9,0,0,0,0,0,0,0,0,0,0,0,0
0,0,0,0,0,0,88,0,0,0,0,0,0,0,0,0,0,0,0,0,0,6,0,664,665,666,667,668,613,614,0,661,662,669,670,669,670,669,670,669,670,671,245,9,0,0,0,0,0,0,0,0,0,0,0
0,0,0,0,0,0,88,0,0,0,0,0,0,0,0,0,0,0,0,672,672,0,0,0,0,665,673,674,675,676,613,0,661,662,677,678,677,679,677,680,677,681,670,9,9,0,0,0,0,0,0,0,0,0,0
0,0,0,0,0,0,88,0,0,0,0,0,0,0,0,0,0,0,0,647,682,683,0,0,0,0,0,665,666,684,685,614,0,661,686,687,670,688,677,689,670,688,677,690,9,9,0,0,0,0,0,0,0,0,0
0,0,0,0,0,0,88,0,0,0,0,0,0,0,0,0,0,0,0,647,648,683,691,0,0,0,0,0,665,692,246,693,613,0,661,694,677,687,677,695,677,689,677,696,697,9,9,0,0,0,0,0,0,0,0
0,0,0,0,0,0,88,0,0,0,0,0,0,0,0,0,0,0,0,647,648,683,651,698,0,0,0,0,0,665,247,699,700,701,0,661,702,688,677,687,670,688,677,687,670,678,9,9,0,0,0,0,0,0,0
0,0,0,0,0,0,88,0,0,0,0,0,0,0,0,0,0,0,0,647,648,683,651,703,0,0,0,0,0,0,0,665,704,615,705,0,661,694,677,696,677,689,677,695,677,689,706,9,9,0,0,0,0,0,0
0,0,0,0,0,0,88,0,0,0,0,0,0,0,0,0,0,0,0,647,648,683,651,650,707,0,0,0,0,0,0,0,665,708,248,616,0,661,662,681,670,669,709,681,670,669,709,678,244,9,0,0,0,0,0
0,0,0,0,0,0,88,0,0,0,0,0,0,0,0,0,0,0,0,647,648,683,651,650,710,711,0,0,0,0,0,0,0,664,712,713,0,0,661,714,709,680,709,680,709,680,709,680,671,245,249,0,0,96,0
0,0,0,0,0,0,88,0,0,0,0,0,0,0,0,0,0,0,0,647,648,683,651,650,651,703,0,0,0,0,0,0,0,0,715,0,0,0,0,716,250,250,250,250,250,250,250,250,250,250,249,0,0,96,0
0,0,0,0,0,0,88,0,0,0,0,0,0,0,0,0,0,0,0,647,648,683,651,650,651,650,707,0,0,0,0,0,0,0,715,0,0,0,0,0,509,509,509,509,509,509,509,509,509,509,509,0,0,96,0
0,0,0,0,0,0,88,0,0,0,0,0,0,0,0,0,0,0,0,647,648,683,651,650,651,650,710,717,0,0,0,0,0,0,715,0,0,0,0,3,0,0,0,0,0,0,0,3,0,0,0,0,0,96,0
0,0,0,0,0,0,88,0,0,0,0,0,0,0,0,0,0,0,0,647,648,683,651,650,651,650,651,718,717,0,0,0,0,0,0,0,0,0,0,241,251,252,0,0,0,0,0,241,251,252,0,0,0,96,0
0,0,0,0,0,0,88,0,0,0,0,0,0,0,0,0,0,0,0,647,648,683,719,650,651,650,651,650,703,711,0,0,0,0,0,0,0,0,0,0,716,249,0,0,0,0,0,0,716,249,0,0,0,96,0
0,0,0,0,0,0,88,0,0,0,0,0,0,0,0,0,0,0,0,239,240,683,720,721,722,650,651,650,651,707,0,0,0,0,0,0,0,0,0,0,509,509,0,0,0,0,0,0,509,509,0,0,0,96,0
0,0,0,0,0,0,88,0,0,0,0,0,0,0,0,0,0,0,0,0,242,243,657,658,659,723,724,650,651,718,717,0,0,0,0,0,0,3,3,3,0,0,0,0,0,0,0,0,0,0,0,0,0,96,0
0,0,0,0,0,0,88,0,0,0,0,0,0,0,0,0,0,0,0,0,0,6,0,664,665,666,667,725,651,650,710,717,0,0,0,0,0,652,726,726,251,0,0,0,0,0,0,0,0,0,0,0,0,96,0
0,0,0,0,0,0,88,0,0,0,0,0,0,0,0,0,0,0,0,672,672,0,0,0,0,665,673,674,727,650,651,728,717,0,0,0,0,652,726,726,251,729,0,0,0,0,0,0,0,0,0,0,0,96,0
0,0,0,0,0,0,88,0,0,0,0,0,0,0,0,0,0,0,0,647,682,730,0,0,0,0,664,665,666,684,668,650,703,0,0,0,0,652,726,726,731,732,729,3,3,3,0,0,0,0,0,0,0,96,0
0,0,0,0,0,0,88,0,0,0,0,0,0,0,0,0,0,0,0,647,648,683,703,0,0,0,0,0,665,692,246,725,651,707,0,0,0,652,726,726,733,734,729,735,726,726,251,3,0,0,0,0,0,96,0
0,0,0,0,0,0,88,0,0,0,0,0,0,0,0,0,0,0,0,647,648,683,651,736,0,0,0,0,0,665,247,699,737,738,711,0,0,241,656,656,251,739,740,735,741,726,251,735,251,252,0,501,1,96,0
0,0,0,0,0,0,88,0,0,0,0,0,0,0,0,0,0,0,0,647,648,683,651,703,0,0,0,0,0,0,664,665,704,667,742,0,0,0,661,662,662,743,744,253,254,255,238,745,238,249,0,746,747,748,0
0,0,0,0,0,0,88,0,0,0,0,0,0,0,0,0,0,0,0,647,648,683,651,650,707,0,0,0,0,0,0,0,665,749,750,751,0,0,0,661,662,752,753,253,14,14,238,754,755,249,0,756,757,758,0
0,0,0,0,0,0,88,0,0,0,0,0,0,0,0,0,0,0,0,647,648,683,651,650,759,717,0,0,0,0,0,0,0,665,760,713,169,0,0,0,761,662,714,256,16,16,238,253,238,249,0,746,762,758,0
0,0,0,0,0,0,88,0,0,0,0,0,0,0,0,0,0,0,0,647,648,683,651,650,651,703,0,0,0,0,0,0,0,0,664,0,0,0,0,0,0,661,714,663,17,17,17,256,238,249,0,747,763,96,0
0,0,0,0,0,0,88,0,96,0,0,0,0,0,0,0,0,0,0,647,648,764,651,650,651,650,707,0,0,0,0,0,0,0,0,0,0,0,0,0,0,0,716,250,250,250,250,250,250,249,0,0,0,96,0
0,0,0,0,0,0,191,147,96,0,0,0,0,0,0,0,0,0,0,765,766,767,768,650,651,650,718,717,0,0,0,0,0,0,0,0,0,0,0,0,0,0,509,509,509,509,509,509,509,509,0,0,0,96,0
0,0,0,0,0,0,0,0,0,0,0,0,0,0,0,0,0,0,0,0,6,0,692,768,651,650,651,710,717,0,0,0,0,0,0,0,0,0,0,0,0,0,0,0,0,0,0,0,0,0,0,0,0,96,0
0,0,0,0,0,0,0,0,0,0,0,0,0,0,0,0,0,0,0,0,0,0,0,692,768,650,651,651,703,0,0,0,0,0,0,0,0,0,0,0,0,0,0,0,0,0,0,0,0,0,0,0,0,96,0
0,0,0,0,0,0,0,0,0,0,0,0,0,0,0,0,0,0,0,0,0,0,0,0,692,768,651,650,650,707,0,0,0,0,0,0,0,0,0,0,0,0,0,0,0,0,0,0,0,0,0,0,0,96,0
0,0,0,0,0,0,0,0,0,0,0,0,0,0,0,0,0,0,0,0,0,0,0,0,0,692,768,650,651,703,0,0,0,0,0,0,0,0,0,0,0,0,0,0,0,0,0,0,0,0,0,0,0,96,0
0,0,0,0,0,0,0,0,0,0,0,0,0,0,0,0,0,0,0,0,0,0,0,0,0,0,692,768,651,650,707,0,0,0,0,0,0,0,0,3,0,0,0,0,0,0,0,3,0,0,0,0,0,96,0
0,0,0,0,0,0,0,0,0,0,0,0,0,0,0,0,0,0,0,0,0,0,0,0,0,0,0,692,768,650,759,717,0,0,0,0,0,0,0,241,251,252,0,0,0,0,0,241,251,252,0,0,0,96,0
0,0,0,0,0,0,0,0,0,0,0,0,0,0,0,0,0,0,0,0,0,0,0,0,0,0,0,0,692,768,651,738,717,0,0,0,0,0,0,0,716,249,0,0,0,0,0,0,716,249,0,0,0,96,0
0,0,0,0,0,0,0,0,0,0,0,0,0,0,0,0,0,0,0,0,0,0,0,0,0,0,0,0,0,692,768,650,703,0,0,0,0,0,0,0,509,509,0,0,0,0,0,0,509,509,0,0,0,96,0
0,0,0,0,0,0,0,0,0,0,0,0,0,0,0,0,0,0,0,0,0,0,0,0,0,0,0,0,0,0,692,768,769,707,0,0,0,0,0,0,0,0,0,0,0,0,0,0,0,0,0,0,0,96,0
0,0,0,0,0,0,0,0,0,0,0,0,0,0,0,0,0,0,0,0,0,0,0,0,0,0,0,0,0,0,0,770,246,718,711,0,0,0,0,0,0,0,0,0,0,0,0,0,0,0,0,0,0,96,0
0,0,0,0,0,0,0,0,0,0,0,0,0,0,0,0,0,0,0,0,0,0,0,0,0,0,0,0,0,0,0,0,771,246,772,0,0,0,0,0,0,0,0,0,0,0,0,0,0,0,0,0,0,96,0
0,0,0,0,0,0,0,0,0,0,0,0,0,0,0,0,0,0,0,0,0,0,0,0,0,0,0,0,0,0,0,0,0,771,773,774,0,0,0,0,0,0,0,0,0,0,0,0,0,0,0,0,0,96,0
0,0,0,0,0,0,0,0,0,0,0,0,0,0,0,0,0,0,0,0,0,0,0,0,0,0,0,0,0,0,0,0,0,0,775,776,169,0,0,0,0,0,0,0,0,0,0,0,0,0,0,0,0,96,0
0,0,0,0,0,0,0,0,0,0,0,0,0,0,0,0,0,0,0,0,0,0,0,0,0,0,0,0,0,0,0,0,0,0,0,0,0,0,0,0,0,0,0,0,0,0,0,0,0,0,0,0,0,0,0
