0,350,350,1,1,1,1,390,391,1,1,1,1,1,1,1,1,0,0,0,0,0,0
0,361,362,363,0,0,0,0,392,393,0,0,0,0,0,0,0,0,0,0,0,0,0
0,2,364,365,366,0,0,0,275,394,395,275,0,0,275,0,0,275,275,0,0,0,0
0,2,361,367,368,366,0,0,279,281,413,279,281,0,279,281,0,279,280,281,0,0,0
0,2,0,369,370,371,372,0,0,282,0,0,282,0,0,282,0,0,282,282,0,0,0
0,2,0,361,367,368,290,293,0,0,0,0,0,0,0,0,0,0,0,0,0,0,0
0,2,0,0,369,374,290,293,0,0,0,0,0,0,0,0,0,0,0,0,0,0,9
0,2,0,0,361,351,294,293,0,0,0,0,0,0,0,0,0,0,0,0,0,0,9
0,2,24,0,0,352,295,296,0,0,0,0,0,0,0,0,0,0,0,0,0,0,9
0,2,24,25,0,0,0,0,0,0,0,0,0,0,0,0,0,0,0,0,0,0,9
0,2,0,617,0,0,0,0,0,0,0,0,0,0,0,0,0,0,0,0,0,0,9
0,2,0,287,288,0,0,0,0,0,0,0,0,0,0,0,0,0,0,0,0,0,9
0,2,0,0,292,0,0,0,0,0,0,0,0,0,0,0,0,0,0,0,0,0,9
0,2,0,286,0,0,0,0,0,0,0,0,0,0,0,0,0,0,0,0,0,0,9
0,2,24,287,288,0,0,0,0,0,0,0,0,0,0,0,0,0,0,0,0,0,9
0,2,24,25,292,0,0,0,0,0,0,0,0,0,0,0,0,0,0,0,0,0,9
0,2,0,617,0,0,0,0,0,0,0,0,0,0,0,0,0,0,0,0,0,0,9
0,0,0,375,288,0,0,0,0,0,0,0,0,0,0,0,0,0,0,0,0,0,9
0,0,0,287,376,0,0,0,0,0,0,0,0,0,0,0,0,0,0,412,515,0,9
0,0,0,0,292,0,0,0,0,0,0,0,0,0,0,0,0,0,678,679,517,115,9
0,0,0,0,0,0,0,0,0,0,0,0,0,0,0,0,0,0,0,146,116,115,680
0,0,0,0,0,0,70,70,70,70,70,70,70,70,70,70,70,70,70,70,121,267,507
0,0,0,0,0,0,0,0,0,0,0,0,0,0,0,0,0,0,0,0,0,0,0
