94,95,35,36,37,38,35,36,37,38,35,36,37,38,35,0,0,0,0,0
39,96,97,16,14,40,15,16,14,40,174,16,14,40,15,16,0,0,0,0
41,26,27,42,17,18,19,42,17,18,19,42,17,18,19,42,17,0,0,0
43,20,28,20,14,40,15,16,14,218,15,175,14,21,15,16,14,21,0,0
44,22,23,22,176,183,187,188,100,46,219,177,52,46,47,99,100,46,47,0
39,24,25,24,48,178,49,49,49,49,49,49,52,52,49,49,49,49,49,189
41,26,27,26,102,103,52,224,224,224,224,224,224,224,224,224,224,224,52,58
43,20,28,20,106,179,52,222,225,225,225,225,225,225,225,225,225,225,329,58
44,22,23,22,45,180,52,222,162,57,57,57,57,57,57,57,57,57,329,58
39,24,25,24,48,54,52,222,162,223,472,472,472,472,472,472,472,472,329,58
41,26,27,26,55,53,52,222,162,223,149,149,149,149,149,149,149,149,329,58
43,20,28,20,48,181,52,222,162,223,149,149,149,149,149,149,149,149,329,58
44,22,23,22,45,103,52,222,162,223,149,149,149,149,149,149,149,149,329,58
39,24,25,24,48,54,52,222,162,223,149,149,149,149,149,149,149,149,329,58
0,26,27,26,55,53,52,222,162,223,149,149,149,149,149,149,149,149,329,58
0,0,28,20,48,181,52,222,162,223,149,149,149,149,149,149,149,149,329,58
0,0,0,22,45,103,52,222,162,223,149,149,149,149,149,149,149,149,329,58
0,0,0,0,48,54,52,309,473,474,477,478,478,478,477,477,477,477,329,58
0,0,0,0,0,53,52,52,52,52,52,52,52,52,52,52,52,52,52,58
0,0,0,0,0,0,60,60,60,60,60,60,60,60,60,60,60,60,60,60
