21,22,22,22,22,22,22,0,0,0,0,0,0,0
23,24,25,25,25,25,25,25,0,0,0,0,0,0
23,24,26,27,25,25,27,25,25,0,0,0,0,0
23,24,30,116,160,27,25,25,27,25,0,0,0,0
23,24,26,116,117,161,31,31,31,31,31,0,0,0
0,24,30,26,253,384,118,36,36,36,36,37,0,0
0,0,26,26,30,59,119,40,40,40,40,41,0,0
0,0,0,30,26,33,122,60,40,40,40,40,61,62
0,0,0,0,26,33,38,39,40,40,40,41,43,43
0,0,0,0,0,33,38,39,40,40,40,41,0,0
0,0,0,0,0,0,123,123,43,43,43,43,0,0
