0,1,1,0,0,0,0,0,0
0,2,0,3,0,0,0,0,0
0,2,0,0,4,0,0,0,0
0,2,5,0,0,0,0,0,0
0,2,0,6,0,0,0,0,0
0,2,0,0,0,0,0,0,0
0,2,5,0,0,0,0,0,0
0,2,0,6,0,0,0,0,0
0,2,0,0,0,0,0,0,0
0,2,5,0,167,167,0,0,0
0,2,0,6,217,0,120,0,0
0,0,0,0,218,0,120,0,0
0,0,0,0,0,219,0,0,0
0,0,0,0,0,218,0,120,0
0,0,0,0,0,0,219,408,0
0,0,0,0,0,0,565,408,201
0,0,0,0,0,0,0,0,566
