0,0,0,0,0,0,0,0,0,0,0,0,0
0,642,642,0,0,0,0,0,0,0,0,0,0
0,117,98,98,0,0,0,0,0,0,0,0,0
0,787,413,229,229,0,0,0,0,0,0,0,0
0,117,117,117,98,98,0,0,0,0,0,0,0
0,0,413,117,413,229,229,0,0,0,0,0,0
0,0,0,117,117,117,98,98,0,0,0,0,0
0,0,0,0,413,117,413,229,229,0,0,0,0
0,0,0,0,0,117,117,117,98,98,0,0,0
0,0,0,0,0,0,413,117,413,788,788,0,0
0,0,0,0,0,0,0,117,117,725,789,789,0
0,0,0,0,0,0,0,0,413,725,0,0,0
0,0,0,0,0,0,0,0,0,725,0,0,0
0,0,0,0,0,0,0,0,0,0,0,0,0
