32,33,34,34,34,34,34,33,34,34,33,34,34,34,33,0,0,0,0,0,0
37,38,39,40,40,40,40,40,39,30,31,39,40,40,40,39,0,0,0,0,0
37,43,44,45,46,46,46,46,46,47,35,36,47,46,46,46,45,0,0,0,0
37,43,50,44,45,46,46,46,46,46,51,41,42,51,46,46,46,45,0,0,0
37,43,50,50,53,54,55,55,55,55,55,54,48,57,54,55,55,55,54,0,0
32,43,50,50,58,67,326,40,60,60,59,59,61,57,68,61,60,59,59,61,0
37,38,50,50,58,65,327,328,57,57,57,57,49,49,57,56,57,57,49,57,0
37,43,44,50,58,65,329,330,49,57,49,49,57,63,57,49,49,49,57,49,0
32,43,50,94,58,65,57,49,57,49,49,57,49,66,49,57,49,49,49,57,0
37,38,50,50,95,65,49,57,63,57,49,49,49,57,57,49,63,57,68,49,0
37,43,44,50,58,67,57,49,57,57,68,57,49,49,63,57,57,57,49,56,0
37,43,50,94,58,65,57,49,49,63,57,56,63,57,57,57,49,63,63,57,0
37,43,50,50,95,65,49,57,49,57,57,49,57,57,49,49,49,57,57,57,0
32,43,50,50,58,67,49,49,57,49,49,49,49,57,49,63,63,57,57,49,0
0,38,50,50,58,65,63,63,57,49,49,63,63,57,57,57,57,57,49,49,0
0,0,44,50,58,65,66,66,49,49,63,63,57,63,57,49,49,57,57,49,0
0,0,0,44,58,65,57,52,57,49,57,57,57,66,49,52,49,49,63,57,0
0,0,0,0,53,65,57,49,56,57,49,57,49,57,57,49,56,57,66,49,0
0,0,0,0,0,67,49,63,57,49,63,63,57,49,49,57,63,57,66,49,0
0,0,0,0,0,0,62,62,62,62,62,62,62,62,62,62,62,62,62,62,0
