0,0,0,0,0,0,0,0,0,0,0,0,0,0,0,0,0,0,0,0,0,0,0,0,0,0,0,0,0,0,0,0,0,0,0,0,0,0,0,0,0,0,0,0,0,0,0,0,0,0,0,0,0,0,0
0,635,8,6,5,25,55,8,6,5,25,55,8,6,5,25,55,8,6,5,25,55,8,6,5,25,55,8,6,5,25,55,56,6,8,25,55,8,6,127,0,0,0,0,0,0,0,0,0,0,0,0,0,0,0
0,635,117,5,55,26,23,24,5,55,26,23,24,5,55,24,23,24,5,23,26,23,24,5,25,26,23,24,5,55,26,23,24,5,55,26,23,24,23,55,129,0,0,0,0,0,0,0,0,0,0,0,0,0,0
0,635,117,413,56,8,8,56,25,56,8,8,56,25,56,8,23,56,25,56,8,8,56,25,56,8,23,56,25,56,8,55,56,25,56,55,8,56,25,56,8,127,0,0,0,0,0,0,0,0,0,0,0,0,0
0,635,117,413,117,25,26,26,23,55,25,26,26,23,55,25,26,26,23,55,25,25,26,23,55,25,26,26,23,55,25,26,26,23,55,25,26,26,23,55,25,26,129,0,0,0,0,0,0,0,0,0,0,0,0
635,92,117,413,117,413,55,24,5,6,6,55,24,5,6,6,55,56,5,6,6,55,23,5,6,6,55,56,5,6,6,55,25,55,6,6,55,24,5,6,6,55,24,127,0,0,0,0,0,0,0,0,0,0,0
635,117,98,413,117,413,84,67,80,25,56,8,26,6,25,56,8,26,6,25,56,8,26,6,25,56,8,26,6,25,56,8,26,6,25,6,537,26,6,25,56,8,26,6,129,0,0,0,0,0,0,0,0,0,0
635,117,413,229,117,413,383,415,83,84,70,80,5,23,55,8,55,5,23,55,8,55,5,23,55,8,55,5,23,55,8,55,5,23,55,538,72,539,23,55,8,55,5,23,55,127,0,0,0,0,0,0,0,0,0
0,692,413,693,694,413,0,0,83,84,69,83,84,86,70,67,86,80,25,8,26,23,6,25,8,26,23,6,25,8,26,23,6,25,8,26,540,149,541,8,26,23,6,25,8,26,129,0,0,0,0,0,0,0,0
0,635,702,693,636,695,696,0,83,117,92,92,84,69,69,69,69,83,84,388,6,24,56,24,26,6,24,56,24,26,6,24,56,24,26,6,24,697,382,544,6,24,56,24,26,6,24,127,0,0,0,0,0,0,0
0,635,117,117,636,695,698,695,83,117,413,98,98,699,69,69,69,83,84,83,84,700,56,8,55,56,25,56,8,55,56,25,56,8,55,56,86,561,69,69,637,86,778,8,55,56,25,56,129,0,0,0,0,0,0
0,635,117,413,702,703,696,704,83,117,413,705,341,706,638,69,69,83,84,83,84,83,84,388,811,811,67,85,67,561,86,67,85,67,561,86,69,69,69,69,69,69,83,117,5,23,26,55,26,127,0,0,0,0,0
0,0,692,413,117,413,707,0,83,708,413,705,341,341,69,69,69,83,84,83,84,83,84,83,812,341,638,69,69,69,69,69,69,69,69,69,69,69,69,69,69,69,83,117,413,8,24,6,8,6,129,0,0,0,0
0,0,635,702,117,413,0,0,83,709,710,705,341,341,813,92,92,814,84,83,84,83,84,83,812,341,69,69,69,69,69,69,69,69,69,69,69,69,69,69,69,69,83,117,413,117,26,25,5,23,24,127,0,0,0
0,0,635,117,117,413,0,0,83,711,639,712,341,341,341,706,706,815,816,92,84,83,117,817,818,341,69,69,69,69,69,69,69,69,69,69,69,92,92,92,92,92,92,117,413,117,713,23,26,55,5,56,129,0,0
0,0,635,117,413,702,84,69,83,117,117,714,715,341,341,341,341,819,640,820,821,92,117,718,341,341,92,92,92,92,92,699,475,69,69,69,69,69,93,93,93,97,98,98,413,117,713,716,717,55,6,55,26,127,0
0,0,635,117,413,117,117,69,83,117,413,718,341,341,341,341,341,822,823,824,825,826,821,705,341,341,341,341,341,341,341,341,0,69,69,69,69,69,69,69,69,83,84,93,97,117,713,716,716,716,717,717,717,717,129
0,0,635,117,413,117,413,702,92,117,413,705,341,341,69,69,69,83,641,827,828,829,830,341,341,341,341,341,341,341,341,341,0,69,69,69,69,69,69,69,69,83,84,69,83,117,713,716,716,716,716,716,716,716,716
0,0,0,117,413,117,413,117,719,97,413,705,341,341,69,69,69,83,84,83,641,831,832,341,341,341,341,341,341,341,341,341,0,69,69,69,69,69,69,69,69,83,84,69,83,117,720,721,721,721,721,721,721,721,721
0,0,0,0,413,117,413,117,118,83,84,718,638,638,69,69,69,83,84,83,84,83,641,341,341,341,341,341,341,341,341,341,0,69,69,69,69,69,69,69,69,83,84,69,83,117,765,0,0,0,0,0,0,0,0
0,0,0,0,0,117,413,117,413,92,84,69,69,69,69,69,69,83,84,83,84,83,84,69,69,83,812,341,341,341,341,341,642,92,92,92,92,92,92,92,92,92,84,69,83,117,765,0,0,0,0,0,0,0,0
0,0,0,0,0,0,413,117,413,117,98,92,92,92,92,92,92,92,84,83,117,92,84,69,69,83,812,341,341,341,341,341,341,341,341,341,341,341,341,833,643,98,98,227,227,834,765,0,0,0,0,0,0,0,0
0,0,0,0,0,0,0,117,413,117,413,229,98,98,98,98,98,98,98,92,117,118,93,69,69,83,812,341,341,341,341,341,341,341,341,341,341,341,341,819,644,341,706,706,835,836,592,0,0,0,0,0,0,0,0
0,0,0,0,0,0,0,0,413,117,413,117,98,229,229,229,229,229,229,229,98,118,69,69,69,83,812,341,341,341,341,341,341,341,341,341,341,341,341,837,838,839,341,341,639,645,594,595,0,0,0,0,0,0,0
0,0,0,0,0,0,0,0,0,117,413,117,118,93,93,93,93,93,93,93,93,93,69,69,69,83,812,341,341,341,341,341,341,341,341,341,341,341,341,69,69,83,646,341,341,647,648,596,595,0,0,0,0,0,0
0,0,0,0,0,0,0,0,0,0,413,117,118,69,69,69,69,69,69,69,69,69,69,69,69,69,718,341,341,341,341,341,341,341,341,341,341,638,638,69,69,83,84,69,83,0,840,841,596,595,0,0,0,0,0
0,0,0,0,0,0,0,0,0,0,0,117,118,69,69,69,69,69,69,69,69,69,69,69,69,69,69,69,842,812,341,341,341,341,341,341,341,69,69,69,69,83,84,69,83,117,0,843,841,594,595,0,0,0,0
0,0,0,0,0,0,0,0,0,0,0,0,118,69,69,69,69,69,69,69,69,69,69,69,69,69,69,69,83,812,341,341,341,341,341,341,341,69,69,69,69,83,84,69,83,117,723,0,843,841,596,595,0,0,0
0,0,0,0,0,0,0,0,0,0,0,0,0,76,76,76,76,76,76,76,76,76,76,76,76,76,76,76,76,812,341,341,341,341,341,341,341,844,76,76,76,76,84,69,83,117,723,0,0,845,841,596,595,0,0
0,0,0,0,0,0,0,0,0,0,0,0,0,0,0,0,0,0,0,0,0,0,0,0,0,0,0,0,0,0,0,0,0,0,0,0,0,0,0,0,0,0,0,76,76,117,723,0,0,0,846,841,594,595,0
0,0,0,0,0,0,0,0,0,0,0,0,0,0,0,0,0,0,0,0,0,0,0,0,0,0,0,0,0,0,0,0,0,0,0,0,0,0,0,0,0,0,0,0,0,0,723,0,0,0,0,847,841,596,848
0,0,0,0,0,0,0,0,0,0,0,0,0,0,0,0,0,0,0,0,0,0,0,0,0,0,0,0,0,0,0,0,0,0,0,0,0,0,0,0,0,0,0,0,0,0,0,0,0,0,0,0,849,850,851
0,0,0,0,0,0,0,0,0,0,0,0,0,0,0,0,0,0,0,0,0,0,0,0,0,0,0,0,0,0,0,0,0,0,0,0,0,0,0,0,0,0,0,0,0,0,0,0,0,0,0,0,0,852,841
0,0,0,0,0,0,0,0,0,0,0,0,0,0,0,0,0,0,0,0,0,0,0,0,0,0,0,0,0,0,0,0,0,0,0,0,0,0,0,0,0,0,0,0,0,0,0,0,0,0,0,0,0,0,847
