0,0,0,0,688,0,0,0,0,0,0,0,0,0,0,0,0,0,0,0,0,0,0,0,0,0,0,0,0,0,0,0,0,0,0,0,0,0,0,0,0,0,0,0,0,0,0
0,0,0,687,676,673,0,0,0,0,0,0,0,0,0,0,0,0,0,0,0,0,0,0,0,0,0,0,0,0,0,0,0,0,0,0,0,0,0,0,0,0,0,0,0,0,0
0,0,688,674,672,677,672,0,0,0,0,0,0,0,0,0,0,0,0,0,0,0,0,0,0,0,0,0,0,0,0,0,0,0,0,0,0,0,0,0,0,0,0,0,0,0,0
0,689,683,673,673,674,675,674,0,0,0,0,0,0,0,0,0,0,0,0,0,0,0,0,0,0,0,0,0,0,0,0,0,0,0,0,0,0,0,0,0,0,0,0,0,0,0
966,684,684,684,672,672,673,676,673,0,0,0,0,0,0,0,0,0,0,0,0,0,0,0,0,0,0,0,0,0,0,0,0,0,0,0,0,0,0,0,0,0,0,0,0,0,0
673,685,685,685,685,674,674,672,677,672,0,0,0,0,0,0,0,0,0,0,0,0,0,0,0,0,0,0,0,0,0,0,0,0,0,0,0,0,0,0,0,0,0,0,0,0,0
684,672,683,683,683,683,673,673,674,675,674,0,0,0,0,0,0,0,0,0,0,0,0,0,0,0,0,0,0,0,0,0,0,0,0,0,0,0,0,0,0,0,0,0,0,0,0
673,685,674,684,684,684,684,672,672,673,676,673,0,0,0,0,0,0,0,0,0,0,0,0,0,0,0,0,0,0,0,0,0,0,0,0,0,0,0,0,0,0,0,0,0,0,0
672,672,683,673,685,685,685,685,674,674,672,677,672,0,0,0,0,0,0,0,0,0,0,0,0,0,0,0,0,0,0,0,0,0,0,0,0,0,0,0,0,0,0,0,0,0,0
672,674,674,684,672,683,683,683,683,673,673,674,675,674,0,0,0,0,0,0,0,0,0,0,0,0,0,0,0,0,0,0,0,0,0,0,0,0,0,0,0,0,0,0,0,0,0
685,674,673,673,685,674,684,684,684,684,672,672,673,676,673,0,0,0,0,0,0,0,0,0,0,0,0,0,0,0,0,0,0,0,0,0,0,0,0,0,0,0,0,0,0,0,0
683,683,673,672,672,683,673,685,685,685,685,674,674,672,673,674,0,0,0,0,0,0,0,0,0,0,0,0,0,0,0,0,0,0,0,0,0,0,0,0,0,0,0,0,0,0,0
674,684,684,672,674,674,684,672,683,683,683,683,673,678,673,676,673,0,0,0,0,0,0,0,0,0,0,0,0,0,0,0,0,0,0,0,0,0,0,0,0,0,0,0,0,0,0
673,673,685,685,674,673,673,685,674,684,684,684,685,674,674,672,677,672,0,0,0,0,0,0,0,0,0,0,0,0,0,0,0,0,0,0,0,0,0,0,0,0,0,0,0,0,0
672,672,672,683,683,673,672,672,683,673,685,678,683,683,673,673,674,675,674,0,0,0,0,0,0,0,0,0,0,0,0,0,0,0,0,0,0,0,0,0,0,0,0,0,0,0,0
684,674,674,674,684,684,672,674,674,684,967,684,684,684,684,672,672,673,676,673,0,0,0,0,0,0,0,0,0,0,0,0,0,0,0,0,0,0,0,0,0,0,0,0,0,0,0
0,685,673,673,673,685,685,674,673,678,683,673,685,685,685,685,674,674,672,677,672,0,0,0,0,0,0,0,0,0,0,0,0,0,0,0,0,0,0,0,0,0,0,0,0,0,0
0,0,683,672,672,672,683,683,678,674,674,684,672,683,683,683,683,673,673,674,675,674,0,0,0,0,0,0,0,0,0,0,0,0,0,0,0,0,0,0,0,0,0,0,0,0,0
0,0,0,684,674,674,674,685,685,674,673,673,685,674,684,684,684,684,672,672,673,676,673,0,0,0,0,0,0,0,0,0,0,0,0,0,0,0,0,0,0,0,0,0,0,0,0
0,0,0,0,685,673,678,672,683,683,673,672,672,683,673,685,685,685,685,674,674,672,677,672,0,0,0,0,0,0,0,0,0,0,0,0,0,0,0,0,0,0,0,0,0,0,0
0,0,0,0,0,968,674,674,674,684,684,672,674,674,684,672,683,683,683,683,673,673,674,675,674,0,0,0,0,0,0,0,0,0,0,0,0,0,0,0,0,0,0,0,0,0,0
0,0,0,0,0,0,685,673,673,673,685,685,674,673,673,685,674,684,684,684,684,672,672,673,676,673,0,0,0,0,0,0,0,0,0,0,0,0,0,0,0,0,0,0,0,0,0
0,0,0,0,0,0,0,683,672,672,672,683,683,673,672,672,683,673,685,685,685,685,674,674,672,677,672,0,0,0,0,0,0,0,0,0,0,0,0,0,0,0,0,0,0,0,0
0,0,0,0,0,0,0,0,684,674,674,674,684,684,672,674,674,684,672,683,683,683,683,673,673,674,675,674,0,0,0,0,0,0,0,0,0,0,0,0,0,0,0,0,0,0,0
0,0,0,0,0,0,0,0,0,685,673,673,673,685,685,674,673,673,685,674,684,684,684,684,672,672,673,676,673,0,0,0,0,0,0,0,0,0,0,0,0,0,0,0,0,0,0
0,0,0,0,0,0,0,0,0,0,683,672,672,672,683,683,673,672,672,683,673,685,685,685,685,674,674,672,677,672,0,0,0,0,0,0,0,0,0,0,0,0,0,0,0,0,0
0,0,0,0,0,0,0,0,0,0,0,684,674,674,674,684,684,672,674,674,684,672,683,683,683,683,673,673,674,675,674,0,0,0,0,0,0,0,0,0,0,0,0,0,0,0,0
0,0,0,0,0,0,0,0,0,0,0,0,685,673,673,673,685,685,674,673,673,685,674,684,684,684,684,672,672,673,676,673,0,0,0,0,0,0,0,0,0,0,0,0,0,0,0
0,0,0,0,0,0,0,0,0,0,0,0,0,683,672,672,672,683,683,673,672,672,683,673,685,685,685,685,674,674,672,677,672,0,0,0,0,0,0,0,0,0,0,0,0,0,0
0,0,0,0,0,0,0,0,0,0,0,0,0,0,684,674,674,674,684,684,672,674,674,684,672,683,683,683,683,673,673,674,675,674,0,0,0,0,0,0,0,0,0,0,0,0,0
0,0,0,0,0,0,0,0,0,0,0,0,0,0,0,685,673,673,673,685,685,674,673,673,685,674,684,684,684,684,672,672,673,676,673,0,0,0,0,0,0,0,0,0,0,0,0
0,0,0,0,0,0,0,0,0,0,0,0,0,0,0,0,683,672,672,672,683,683,673,672,672,683,673,685,685,685,685,674,674,672,677,672,0,0,0,0,0,0,0,0,0,0,0
0,0,0,0,0,0,0,0,0,0,0,0,0,0,0,0,0,684,674,674,674,684,684,672,674,674,684,672,683,683,683,683,673,673,674,675,674,0,0,0,0,0,0,0,0,0,0
0,0,0,0,0,0,0,0,0,0,0,0,0,0,0,0,0,0,685,673,673,673,685,685,674,673,673,685,674,684,684,684,684,672,672,673,676,673,0,0,0,0,0,0,0,0,0
0,0,0,0,0,0,0,0,0,0,0,0,0,0,0,0,0,0,0,683,672,672,672,683,683,673,672,672,683,673,685,685,685,685,674,674,672,677,672,0,0,0,0,0,0,0,0
0,0,0,0,0,0,0,0,0,0,0,0,0,0,0,0,0,0,0,0,684,674,674,674,684,684,672,674,674,684,672,683,683,683,683,673,673,674,675,674,0,0,0,0,0,0,0
0,0,0,0,0,0,0,0,0,0,0,0,0,0,0,0,0,0,0,0,0,685,673,673,673,685,685,674,673,673,685,674,684,684,684,684,672,672,673,676,673,0,0,0,0,0,0
0,0,0,0,0,0,0,0,0,0,0,0,0,0,0,0,0,0,0,0,0,0,683,672,672,672,683,683,673,672,672,683,673,685,685,685,685,674,674,672,677,672,0,0,0,0,0
0,0,0,0,0,0,0,0,0,0,0,0,0,0,0,0,0,0,0,0,0,0,0,684,674,674,674,684,684,672,674,674,684,672,683,683,683,683,673,673,674,675,674,0,0,0,0
0,0,0,0,0,0,0,0,0,0,0,0,0,0,0,0,0,0,0,0,0,0,0,0,685,673,673,673,685,685,674,673,673,685,674,684,684,684,684,672,672,673,676,673,0,0,0
0,0,0,0,0,0,0,0,0,0,0,0,0,0,0,0,0,0,0,0,0,0,0,0,0,683,672,672,672,683,683,673,672,672,683,673,685,685,685,685,674,674,672,677,672,0,0
0,0,0,0,0,0,0,0,0,0,0,0,0,0,0,0,0,0,0,0,0,0,0,0,0,0,684,674,674,674,684,684,672,674,674,684,672,683,683,683,683,673,673,674,675,674,0
0,0,0,0,0,0,0,0,0,0,0,0,0,0,0,0,0,0,0,0,0,0,0,0,0,0,0,685,673,673,673,685,685,674,673,673,685,674,684,684,684,684,672,672,673,676,686
0,0,0,0,0,0,0,0,0,0,0,0,0,0,0,0,0,0,0,0,0,0,0,0,0,0,0,0,683,672,672,672,683,683,673,672,672,683,673,685,685,685,685,674,674,672,969
0,0,0,0,0,0,0,0,0,0,0,0,0,0,0,0,0,0,0,0,0,0,0,0,0,0,0,0,0,970,674,674,674,970,970,967,674,674,970,967,692,692,692,692,679,679,686
0,0,0,0,0,0,0,0,0,0,0,0,0,0,0,0,0,0,0,0,0,0,0,0,0,0,0,0,0,0,693,693,693,693,693,693,693,693,693,693,693,693,693,693,693,693,693
