0,51,51,51,51,51,51,51,51,51,51,0,0,0,0,0,0,0
0,4,0,0,0,0,0,0,0,0,0,0,0,0,0,0,0,0
0,4,0,0,0,0,0,0,0,0,0,0,0,0,0,0,0,0
0,4,0,0,0,0,0,0,0,0,0,0,0,0,0,0,0,0
0,4,0,0,0,0,0,0,0,0,0,0,0,0,0,0,0,0
0,4,0,0,0,0,52,52,52,52,52,52,52,52,52,52,0,0
0,4,0,0,0,0,53,0,0,0,0,0,0,0,0,0,0,0
0,4,0,0,0,0,53,0,0,0,0,0,0,0,0,0,0,0
0,4,0,0,0,0,53,0,0,0,0,0,0,0,0,0,0,0
0,4,0,0,0,0,53,0,0,0,0,0,0,0,0,0,0,0
0,4,0,0,0,0,53,0,0,0,0,0,0,0,0,0,0,0
0,4,0,0,0,0,53,0,0,0,0,0,0,0,0,0,0,0
0,0,0,0,0,0,53,0,0,0,0,0,0,0,0,0,0,0
0,0,0,0,0,0,53,0,0,0,0,0,0,0,0,0,0,0
0,0,0,0,0,0,53,0,0,0,0,0,0,0,0,0,0,0
0,0,0,0,0,0,53,0,0,0,0,0,0,0,0,0,0,0
0,0,0,0,0,0,53,0,0,0,0,0,0,0,0,0,0,0
0,0,0,0,0,0,0,0,0,0,0,0,0,0,0,0,0,0
