35,36,37,37,37,38,0,0,0,0,0,0
35,153,120,121,121,121,154,0,0,0,0,0
35,127,155,156,125,408,125,157,0,0,0,0
35,127,128,538,539,125,409,125,157,0,0,0
35,127,128,523,344,345,125,812,125,157,0,0
35,127,128,523,344,346,347,813,0,411,814,0
0,132,128,128,351,346,352,53,0,0,0,0
0,0,136,128,128,355,352,53,53,109,0,0
0,0,0,136,128,133,356,53,53,53,53,0
0,0,0,0,136,133,53,53,53,53,53,0
0,0,0,0,0,141,53,53,53,53,53,0
0,0,0,0,0,0,55,53,53,55,55,0
0,0,0,0,0,0,0,109,53,0,0,0
0,0,0,0,0,0,0,0,55,0,0,0
