0,1,1,1,1,1,1,1,1,1,1,1,1,1,1,0,0,0,0,0
0,2,0,0,0,0,0,0,0,0,0,0,0,0,0,0,0,0,0,0
0,2,0,0,0,0,0,0,0,0,0,0,0,0,168,169,0,0,0,0
0,2,0,0,0,0,0,0,0,0,0,0,0,0,170,171,48,0,0,0
0,2,0,0,0,0,0,0,0,0,0,0,0,0,0,172,173,48,0,0
0,2,0,0,0,0,3,3,3,3,3,3,3,3,3,3,174,175,49,3
0,2,0,0,0,0,4,0,0,0,0,0,0,0,0,0,0,0,0,0
0,0,0,0,0,0,4,0,0,0,0,0,0,0,0,0,0,0,0,0
0,0,0,0,0,0,4,0,0,0,0,0,0,0,0,0,0,0,0,0
0,0,0,0,0,0,4,0,0,0,0,0,0,0,0,0,0,0,0,0
0,0,0,0,0,0,4,0,0,0,0,0,0,0,0,0,0,0,0,0
0,0,0,0,0,0,4,0,0,0,0,0,0,0,0,0,0,0,0,0
0,0,0,0,0,0,0,0,0,0,0,0,0,0,0,0,0,0,0,0
