0,0,0,0,0,0,0,0,0,0,0,0,0,0,0,459,0,0,0,0,0,0,0,0,0,0,0,0,0,0,0,0,0,0,0,0,0,0,0,0,0,0,0,0,0,0,0,0,0,0,0,0,0,0,0,0,0,0
0,0,0,0,0,0,0,0,0,0,0,0,0,0,0,622,466,0,0,0,0,0,0,0,0,0,0,0,0,0,0,0,0,0,0,0,0,0,0,0,0,0,0,0,0,0,0,0,0,0,0,0,0,0,0,0,0,0
0,0,16,16,240,240,240,16,240,240,83,83,240,16,240,623,624,625,53,0,0,0,0,0,0,0,0,0,0,0,0,0,0,0,0,0,0,0,0,0,0,0,0,0,0,0,0,0,0,0,0,0,0,0,0,0,0,0
0,12,19,19,19,353,353,626,30,56,627,241,353,628,30,623,629,19,623,54,630,0,0,0,0,0,38,0,0,0,0,0,0,0,0,0,0,0,0,0,0,0,0,0,0,0,0,0,0,0,0,0,0,0,0,0,0,0
0,34,34,34,34,631,353,353,628,30,353,242,353,353,89,623,353,632,34,633,634,54,201,0,243,428,9,8,0,0,0,0,0,0,0,0,0,0,0,0,0,0,0,0,0,0,0,0,0,0,0,0,0,0,0,0,0,0
16,244,34,34,34,245,635,242,626,30,636,241,241,353,89,636,353,353,637,30,34,638,639,199,0,440,640,378,10,0,0,0,0,0,0,0,0,0,0,0,0,0,0,0,0,0,0,0,0,0,0,0,0,0,0,0,0,0
12,30,19,132,132,245,246,242,241,628,623,241,242,242,641,636,641,353,242,637,30,19,247,642,643,644,645,646,647,648,0,0,0,0,0,0,0,0,0,0,0,0,0,0,0,0,0,0,0,0,0,0,0,0,0,0,0,0
16,34,19,34,244,244,245,631,242,353,30,56,242,242,637,30,353,353,242,353,626,19,34,649,650,25,248,651,249,652,653,654,0,0,0,0,0,0,0,0,0,0,0,0,0,0,0,0,0,0,0,0,0,0,0,0,0,0
12,19,132,34,19,19,19,138,635,353,30,623,241,242,242,626,623,56,242,242,655,628,34,19,656,250,657,658,131,659,660,652,653,654,0,0,0,661,662,663,0,0,0,0,0,0,0,0,0,0,0,0,0,0,0,0,0,0
16,34,34,244,30,34,34,34,631,353,89,623,56,242,242,242,626,353,56,353,353,637,664,19,665,666,251,131,131,667,668,669,660,652,653,654,0,670,252,252,0,0,0,0,0,0,0,0,0,0,0,0,0,0,0,0,0,0
12,19,253,19,30,19,132,19,19,635,353,636,241,241,242,242,242,353,641,241,242,353,626,30,665,658,131,131,652,671,672,673,660,652,674,652,675,676,677,373,28,678,0,0,0,0,0,0,0,0,0,0,0,0,0,0,0,0
12,34,19,19,34,30,34,138,34,34,353,56,56,353,353,353,353,353,353,56,353,353,641,628,679,254,131,131,652,680,34,34,681,652,682,652,674,683,131,684,28,624,685,459,0,0,0,0,0,0,0,0,0,0,0,0,0,0
16,34,19,132,255,256,19,19,253,19,20,36,36,36,36,36,36,36,36,36,36,36,36,36,686,249,131,131,131,687,257,688,668,689,674,690,656,691,131,684,28,30,30,622,466,0,0,0,0,0,0,0,0,0,0,0,0,0
12,19,34,253,246,258,245,34,34,19,20,25,25,25,25,25,25,25,25,25,25,25,25,25,692,0,259,259,259,259,0,19,693,694,695,696,697,698,131,684,28,30,19,19,624,474,699,260,260,260,260,260,0,0,0,0,0,0
12,34,34,261,34,247,642,700,261,34,20,25,28,355,701,355,355,701,355,701,701,355,701,701,702,0,0,0,0,0,0,0,19,703,704,705,706,707,131,708,28,19,19,34,34,19,624,709,262,263,262,262,262,0,0,0,0,0
12,19,34,19,19,34,649,629,245,30,20,25,28,30,353,353,353,353,353,353,353,353,353,353,710,0,0,0,0,0,0,0,0,711,712,19,713,707,131,708,28,30,34,34,19,19,34,264,262,263,265,263,262,262,0,0,0,0
16,132,255,256,132,255,256,714,715,138,20,25,28,34,19,241,266,267,266,267,241,241,266,267,716,0,268,0,268,0,0,0,0,0,717,19,718,719,720,721,722,269,269,19,19,34,34,264,265,263,265,262,265,263,262,0,0,0
12,19,246,258,245,246,258,245,30,34,20,25,28,30,19,361,0,0,0,0,723,241,0,0,0,0,0,0,0,0,0,0,270,0,0,724,675,725,271,271,726,726,727,269,34,34,30,264,262,262,272,262,263,262,272,370,0,0
12,34,34,247,642,700,247,642,700,728,20,25,28,34,19,361,0,0,0,0,729,0,0,0,0,0,0,0,0,0,0,0,0,270,0,0,730,731,732,733,734,735,736,737,727,269,269,264,265,263,262,262,262,272,262,738,0,0
12,19,261,253,649,629,245,649,629,245,739,25,28,30,19,361,0,0,0,0,740,0,0,0,0,0,0,0,0,0,0,0,0,0,0,0,741,742,743,744,745,746,34,747,748,737,245,264,262,262,265,262,273,263,272,370,0,0
12,34,253,19,261,714,715,34,714,715,20,28,355,626,19,361,0,0,0,0,749,0,0,0,0,0,750,270,668,0,0,0,0,0,0,0,741,742,751,752,745,746,34,19,623,748,753,265,262,263,262,262,262,263,262,738,0,0
12,34,253,34,253,19,261,19,19,30,20,28,34,353,754,34,0,755,756,0,0,0,268,0,0,0,0,750,274,131,0,0,0,0,0,0,741,742,757,752,745,746,34,728,34,633,353,758,759,262,265,262,262,263,265,370,0,0
12,253,19,19,34,19,253,19,253,34,20,28,30,760,761,275,762,0,763,764,0,765,131,351,0,0,0,0,276,131,131,277,277,277,277,277,766,742,751,752,767,746,34,623,637,19,34,633,768,265,263,262,262,262,263,370,0,0
12,253,261,132,255,256,253,19,253,19,20,28,30,760,769,770,668,771,278,763,277,0,772,277,277,277,277,277,741,131,131,131,279,279,279,279,279,773,757,131,774,131,34,19,633,626,34,30,34,262,262,265,263,263,262,738,0,0
16,253,261,19,246,258,245,19,34,19,20,28,30,760,769,257,775,280,776,279,279,279,279,777,778,279,279,279,279,131,131,131,131,131,131,131,131,773,751,131,131,131,34,19,30,30,628,30,19,265,262,263,262,272,265,370,0,0
16,30,261,261,34,247,642,700,34,34,20,28,30,760,769,257,775,131,131,131,131,773,779,779,779,780,131,131,131,131,779,779,779,779,779,779,779,779,757,131,131,131,34,34,34,728,34,34,19,265,265,262,265,262,265,781,0,0
12,19,19,261,261,253,649,629,245,34,20,28,30,19,769,257,775,131,131,131,773,779,779,782,782,783,783,131,131,131,131,782,782,782,782,782,782,782,782,131,131,131,34,34,34,623,637,30,132,262,262,263,262,263,262,262,262,0
16,34,34,34,34,30,30,714,715,728,20,28,30,19,19,257,775,131,131,131,773,783,782,131,131,131,783,757,131,131,131,131,131,131,131,131,131,131,131,131,131,131,34,19,30,34,633,626,19,265,263,262,265,262,265,262,262,370
12,19,19,34,34,19,19,623,728,30,784,28,30,34,34,668,775,131,131,131,785,783,131,131,131,131,785,757,131,131,131,259,259,259,259,131,131,131,131,131,131,131,34,34,34,728,30,19,628,264,265,265,263,262,262,262,262,370
0,34,34,34,19,34,34,34,633,628,20,28,19,19,34,660,280,131,131,131,785,783,786,131,131,131,773,757,786,131,131,259,0,0,0,281,282,131,131,131,131,131,34,34,34,623,637,19,34,264,265,262,262,265,263,262,262,370
0,0,283,34,19,34,19,19,19,34,20,28,30,34,34,660,131,131,131,131,131,779,783,777,131,773,785,757,131,131,131,259,0,0,0,0,0,282,131,752,284,787,34,34,19,34,633,626,34,264,265,262,262,285,262,272,262,370
0,0,0,286,34,34,19,34,34,34,30,28,30,19,34,660,131,131,131,131,131,131,779,783,783,783,779,782,131,131,131,259,0,0,0,281,0,287,274,752,788,789,19,19,30,30,30,19,628,264,265,265,262,262,273,263,265,370
0,0,0,0,288,139,19,34,19,34,19,19,19,19,34,728,34,131,131,131,131,131,131,782,782,782,782,131,131,131,131,259,0,0,0,0,0,750,790,752,788,789,289,34,34,728,34,19,34,264,265,262,262,263,262,263,265,370
0,0,0,0,0,0,140,290,19,34,34,34,34,245,34,353,626,34,660,131,131,131,131,131,131,131,131,131,131,131,131,259,291,0,0,281,0,750,274,752,788,789,19,34,34,623,637,30,34,264,265,262,262,262,265,262,265,370
0,0,0,0,0,0,0,0,286,34,19,19,34,30,245,34,353,660,34,131,791,791,792,131,131,131,131,131,131,131,131,131,0,0,0,0,287,750,274,752,788,789,19,793,34,34,633,626,19,264,265,262,262,262,262,262,262,370
0,0,0,0,0,0,0,0,0,794,19,34,34,30,19,292,293,293,259,795,0,796,797,798,131,131,131,131,131,131,131,131,131,0,131,0,294,287,274,752,788,789,19,34,19,34,30,19,628,264,265,262,263,262,262,263,262,370
0,0,0,0,0,0,0,0,0,0,799,728,34,19,19,34,293,0,0,0,0,0,800,131,131,131,131,131,131,131,131,131,131,131,131,131,0,294,790,752,788,789,19,34,30,30,30,19,34,264,265,262,265,265,262,262,265,370
0,0,0,0,0,0,0,0,0,0,0,353,637,30,34,34,293,0,0,0,0,0,801,131,131,131,131,131,131,131,131,131,752,295,277,277,277,131,276,752,788,789,19,34,34,728,34,19,34,264,265,262,262,262,262,262,262,370
0,0,0,0,0,0,0,0,0,0,0,353,353,626,19,30,293,0,0,0,0,0,802,131,131,783,783,783,783,773,773,773,773,803,296,296,296,296,297,752,788,789,19,34,34,623,637,30,34,264,262,263,285,263,262,262,262,370
0,0,0,0,0,0,0,0,0,0,0,0,353,353,628,34,292,0,804,0,0,0,805,131,131,783,806,131,131,131,131,131,131,131,131,252,298,298,131,752,788,789,19,34,30,34,633,626,19,264,265,263,265,272,265,262,262,370
0,0,0,0,0,0,0,0,0,0,0,0,807,242,641,19,19,19,0,0,0,0,802,284,792,783,806,131,131,131,131,131,131,752,284,791,791,791,791,791,788,789,19,34,34,728,30,19,628,264,263,265,265,262,265,262,263,370
0,0,0,0,0,0,0,0,0,0,0,0,0,353,353,637,361,299,808,809,810,811,812,813,797,814,806,131,131,131,131,131,131,752,815,816,817,817,817,817,817,818,19,34,34,623,637,19,34,264,265,265,262,262,263,262,262,370
0,0,0,0,0,0,0,0,0,0,0,0,0,0,242,242,626,0,0,0,0,0,0,0,819,300,300,131,131,131,131,131,131,131,820,821,821,821,821,821,821,821,19,34,30,728,633,628,34,264,265,262,262,265,262,272,262,370
0,0,0,0,0,0,0,0,0,0,0,0,0,0,353,242,353,628,355,355,355,355,355,355,822,301,301,302,355,355,355,355,823,823,823,823,823,823,823,823,823,823,728,34,30,623,637,34,34,264,263,262,262,262,273,263,265,370
0,0,0,0,0,0,0,0,0,0,0,0,0,0,0,353,242,637,631,353,242,242,353,242,353,824,303,303,825,242,242,242,353,242,242,242,242,242,242,242,242,242,353,637,30,728,633,626,19,264,262,272,262,262,263,263,265,370
0,0,0,0,0,0,0,0,0,0,0,0,0,0,0,826,242,353,626,635,241,241,242,242,353,827,301,301,302,353,353,242,242,242,353,242,242,353,353,242,242,242,242,242,828,623,637,30,628,264,263,273,265,265,262,265,265,370
0,0,0,0,0,0,0,0,0,0,0,0,0,0,0,0,353,353,353,631,353,353,353,353,242,353,824,303,303,829,353,353,353,242,353,353,353,242,353,353,353,242,241,353,353,353,633,626,19,264,262,272,262,262,262,263,262,370
0,0,0,0,0,0,0,0,0,0,0,0,0,0,0,0,830,353,353,831,635,633,637,637,353,353,832,301,302,302,302,353,353,242,241,641,353,242,241,641,353,242,241,353,353,353,833,30,628,264,272,263,265,262,265,265,272,370
0,0,0,0,0,0,0,0,0,0,0,0,0,0,0,0,834,835,836,837,838,839,840,836,841,842,841,843,304,304,844,845,846,353,353,353,353,353,353,353,353,353,353,353,353,353,637,30,19,264,262,265,265,263,262,272,370,0
0,0,0,0,0,0,0,0,0,0,0,0,0,0,847,848,849,850,850,850,850,850,850,850,850,850,850,850,131,131,851,25,852,853,353,641,626,353,242,641,626,353,242,641,626,353,353,626,19,264,263,263,262,262,272,370,0,0
0,0,0,0,0,0,0,0,0,0,0,0,0,0,305,848,854,855,855,855,855,855,855,855,855,855,855,855,855,856,856,306,28,34,635,56,56,628,637,353,56,628,353,353,56,628,637,56,628,264,265,265,265,272,370,0,0,0
0,0,0,0,0,0,0,0,0,0,0,0,0,0,0,857,307,25,25,25,25,25,25,25,25,25,25,25,359,359,25,25,28,628,858,633,308,308,264,308,308,308,264,308,308,308,264,308,308,262,263,262,263,370,0,0,0,0
0,0,0,0,0,0,0,0,0,0,0,0,0,0,0,0,0,25,25,852,355,355,355,355,355,355,355,355,355,355,355,355,355,626,34,34,34,262,262,263,262,262,265,285,263,262,262,263,265,262,263,272,370,0,0,0,0,0
0,0,0,0,0,0,0,0,0,0,0,0,0,0,0,0,0,369,369,28,34,353,353,353,353,353,353,353,353,353,353,353,353,353,628,34,30,265,263,262,265,263,272,265,272,265,263,263,265,262,263,370,0,0,0,0,0,0
0,0,0,0,0,0,0,0,0,0,0,0,0,0,0,0,305,309,25,28,628,34,353,353,353,353,353,353,353,353,353,353,353,353,353,34,30,272,262,265,262,265,265,272,265,265,273,265,265,263,370,0,0,0,0,0,0,0
0,0,0,0,0,0,0,0,0,0,0,0,0,0,0,0,0,355,355,355,637,34,30,308,859,308,859,308,308,308,308,860,859,308,859,308,34,265,272,265,262,262,265,262,272,265,262,285,263,370,0,0,0,0,0,0,0,0
0,0,0,0,0,0,0,0,0,0,0,0,0,0,0,0,0,0,353,353,353,626,34,264,263,265,263,265,263,262,262,262,265,265,263,272,263,262,262,265,272,265,262,265,263,272,262,263,370,0,0,0,0,0,0,0,0,0
0,0,0,0,0,0,0,0,0,0,0,0,0,0,0,0,0,0,826,353,353,353,628,264,265,265,263,265,263,265,262,262,263,263,263,265,272,265,263,263,262,265,272,263,262,265,272,370,0,0,0,0,0,0,0,0,0,0
0,0,0,0,0,0,0,0,0,0,0,0,0,0,0,0,0,0,0,310,310,310,310,370,370,370,370,370,370,370,370,370,370,370,370,370,370,370,370,370,370,370,370,370,370,370,370,0,0,0,0,0,0,0,0,0,0,0
