0,0,0,0,0,0,0,0,0,0,0,0,0,0,0,0,0,0,0,0,0,0,0,0,0,0,0,1,1,0,0,0,0,0,0,0,0,0,0,0,0,0,0,0,0,0
0,0,0,0,0,0,0,0,0,0,0,0,0,0,0,0,0,0,0,0,0,0,0,0,0,0,0,2,3,4,0,0,0,0,0,0,0,0,0,0,0,0,0,0,0,0
0,5,5,5,5,5,5,5,5,5,5,5,5,5,5,5,5,5,5,5,5,5,5,5,5,5,5,6,7,8,9,5,5,5,5,5,5,5,5,5,5,5,5,5,5,5
10,11,0,27,0,0,0,0,0,0,0,0,0,0,0,0,0,0,0,0,0,0,0,0,0,0,0,6,7,12,0,0,0,0,0,0,0,0,0,0,0,0,0,0,0,0
14,11,14,28,29,0,0,0,0,0,0,0,0,0,0,0,0,0,0,0,0,0,0,0,0,0,0,6,7,12,0,0,0,0,0,0,0,0,0,0,0,0,0,0,0,0
14,11,30,31,32,33,31,31,31,0,0,0,0,0,0,0,0,0,0,0,0,0,0,0,0,0,0,2,3,4,0,0,0,0,0,0,0,0,0,0,0,0,0,0,0,0
0,15,34,35,36,37,36,35,38,39,0,0,0,0,40,40,40,40,40,40,40,40,0,0,0,0,0,6,7,8,16,0,0,0,0,0,0,0,0,0,0,0,0,0,0,0
10,11,0,41,42,43,42,43,42,44,45,0,0,0,46,47,47,47,47,47,47,48,49,0,0,0,0,6,7,12,0,0,0,0,0,0,0,0,0,0,0,0,0,0,0,0
14,11,13,0,51,42,52,42,52,42,53,45,0,0,46,54,55,56,55,56,55,57,58,59,0,0,0,6,7,12,0,0,0,0,0,0,0,0,0,0,0,0,0,0,0,0
0,15,0,0,0,60,61,62,61,63,61,64,45,0,65,66,67,68,69,68,69,70,71,72,73,0,0,2,3,4,0,0,0,0,0,0,0,0,0,0,0,0,0,0,0,0
0,15,0,0,0,0,74,75,76,75,76,75,77,45,0,78,79,80,81,81,81,81,82,83,59,0,0,6,7,8,16,0,0,0,0,0,0,0,0,0,0,0,0,0,0,0
10,11,0,0,0,0,0,85,43,86,43,42,43,87,45,46,54,80,81,81,81,81,57,88,72,73,0,6,7,12,0,0,0,0,0,0,0,0,0,0,0,0,0,0,0,0
14,11,13,0,0,0,0,0,89,42,42,42,42,42,90,45,66,91,92,92,92,92,70,93,72,94,0,6,7,12,0,0,0,0,0,0,0,0,0,0,0,0,0,0,0,0
0,15,0,0,0,0,0,0,0,89,95,42,95,42,95,96,45,79,97,98,99,98,99,82,100,94,101,2,3,4,0,0,0,0,0,0,0,0,0,0,0,0,0,0,0,0
0,15,0,0,0,0,0,0,0,0,102,103,104,103,104,103,87,45,105,106,107,108,107,57,109,110,111,6,7,8,16,0,0,0,0,0,0,0,0,0,0,0,0,0,0,0
10,11,0,0,0,0,0,0,0,0,0,112,113,114,113,114,113,115,45,106,105,116,117,57,109,118,119,6,7,12,0,0,0,0,0,0,0,0,0,0,0,0,0,0,0,0
14,11,13,0,0,0,0,0,0,0,0,0,121,42,42,42,122,42,123,45,105,116,117,57,109,124,245,2,3,4,0,0,0,0,0,0,0,0,0,0,0,0,0,0,0,0
0,15,0,0,0,0,0,0,0,0,0,0,0,125,126,127,128,129,128,130,131,116,117,57,109,118,246,17,18,19,16,0,0,0,0,0,0,0,0,0,0,0,0,0,0,0
0,15,0,0,0,0,0,0,0,0,0,0,0,0,133,134,135,136,137,138,139,140,141,57,109,124,247,20,21,22,16,0,0,0,0,0,0,0,0,0,0,0,0,0,0,0
10,11,0,0,0,0,0,0,0,0,0,0,0,0,0,45,45,142,143,144,145,145,145,146,109,118,119,248,23,24,0,0,0,0,0,0,0,0,0,0,0,0,0,0,0,0
14,11,13,0,0,0,0,0,0,0,0,0,0,0,0,0,45,147,81,148,149,81,81,150,58,94,111,120,132,0,0,0,0,0,0,0,0,0,0,0,0,0,0,0,0,0
0,15,0,0,0,0,0,0,0,0,0,0,0,0,0,0,46,151,152,152,152,152,152,150,58,94,111,120,132,0,0,0,0,0,0,0,0,0,0,0,0,0,0,0,0,0
0,15,0,0,0,0,0,0,0,0,0,0,0,0,0,0,46,0,0,0,0,0,0,153,58,94,111,120,132,0,0,0,0,0,0,0,0,0,0,0,0,0,0,0,0,0
10,11,0,0,0,0,0,0,0,0,0,0,0,0,0,0,154,154,0,0,154,155,0,153,156,94,111,120,132,0,0,0,0,0,0,0,0,0,0,0,0,0,0,0,0,0
14,11,13,0,0,0,0,0,0,0,0,0,0,0,0,0,45,157,45,154,158,159,160,161,156,162,163,120,132,0,0,0,0,0,0,0,0,0,0,0,0,0,0,0,0,0
0,15,0,0,0,0,0,0,0,0,0,0,0,0,0,0,0,164,165,166,167,168,169,0,170,171,172,249,132,0,0,0,0,0,0,0,0,0,0,0,0,0,0,0,0,0
0,15,0,0,0,0,0,0,0,0,0,0,0,0,0,0,0,0,173,174,175,176,177,178,179,180,250,251,84,0,0,0,0,0,0,0,0,0,0,0,0,0,0,0,0,0
10,11,0,0,0,0,0,0,0,0,0,0,0,0,0,0,0,0,0,181,182,183,184,179,180,250,252,253,0,0,0,0,0,0,0,0,0,0,0,0,0,0,0,0,0,0
14,11,13,0,0,0,0,0,0,0,0,0,0,0,0,0,0,0,0,0,0,185,254,255,256,50,257,0,0,0,0,0,0,0,0,0,0,0,0,0,0,0,0,0,0,0
0,15,0,0,0,0,0,0,0,0,0,0,0,0,0,0,0,0,0,0,0,0,0,0,258,257,0,0,0,0,0,0,0,0,0,0,0,0,0,0,0,0,0,0,0,0
0,0,0,0,0,0,0,0,0,0,0,0,0,0,0,0,0,0,0,0,0,0,0,0,0,0,0,0,0,0,0,0,0,0,0,0,0,0,0,0,0,0,0,0,0,0
0,0,0,0,0,0,0,0,0,0,0,0,0,0,0,0,0,0,0,0,0,0,0,0,0,0,0,0,0,0,0,0,0,0,0,0,0,0,0,0,0,0,0,0,0,0
0,0,0,0,0,0,0,0,0,0,0,0,0,0,0,0,0,0,0,0,0,0,0,0,0,0,0,0,0,0,0,0,0,0,0,0,0,0,0,0,0,0,0,0,0,0
0,0,0,0,0,0,0,0,0,0,0,0,0,0,0,0,0,0,0,0,0,0,0,0,0,0,0,0,0,0,0,0,0,0,0,0,0,0,0,0,0,0,0,0,0,0
0,0,0,0,0,0,0,0,0,0,0,0,0,0,0,0,0,0,0,0,0,0,0,0,0,0,0,0,0,0,0,0,0,0,0,0,0,0,0,0,0,0,0,0,0,0
0,0,0,0,0,0,0,0,0,0,0,0,0,0,0,0,0,0,0,0,0,0,0,0,0,0,0,0,0,0,0,0,0,0,0,0,0,0,0,0,0,0,0,0,0,0
0,0,0,0,0,0,0,0,0,0,0,0,0,0,0,0,0,0,0,0,0,0,0,0,0,0,0,0,0,0,0,0,0,0,0,0,0,0,0,0,0,0,0,0,0,0
0,0,0,0,0,0,0,0,0,0,0,0,0,0,0,0,0,0,0,0,0,0,0,0,0,0,0,0,0,0,0,0,0,0,0,0,0,0,0,0,0,0,0,0,0,0
0,0,0,0,0,0,0,0,0,0,0,0,0,0,0,0,0,0,0,0,0,0,0,0,0,0,0,0,0,0,0,0,0,0,0,0,0,0,0,0,0,0,0,0,0,0
0,0,0,0,0,0,0,0,0,0,0,0,0,0,0,0,0,0,0,0,0,0,0,0,0,0,0,0,0,0,0,0,0,0,0,0,0,0,0,0,0,0,0,0,0,0
0,0,0,0,0,0,0,0,0,0,0,0,0,0,0,0,0,0,0,0,0,0,0,0,0,0,0,0,0,0,0,0,0,0,0,0,0,0,0,0,0,0,0,0,0,0
0,0,0,0,0,0,0,0,0,0,0,0,0,0,0,0,0,0,0,0,0,0,0,0,0,0,0,0,0,0,0,0,0,0,0,0,0,0,0,0,0,0,0,0,0,0
