0,1,1,1,1,1,1,1,1,0,0,0,0,0,0,0,0
0,2,0,0,0,0,0,0,0,0,0,0,0,0,0,0,0
0,2,0,0,0,0,3,0,3,0,0,0,0,0,0,0,0
0,2,0,0,0,0,0,4,286,4,0,0,0,0,0,0,0
0,2,0,0,0,97,0,0,0,290,0,0,97,0,0,0,0
0,2,0,0,0,98,99,0,0,0,293,0,81,99,0,0,0
0,2,0,0,0,0,100,83,0,0,0,0,0,82,83,0,0
0,0,0,0,0,0,0,0,0,0,0,0,0,0,688,1,0
0,0,0,0,0,101,0,0,0,0,0,0,0,0,0,0,120
0,0,0,0,0,194,102,0,0,0,0,0,0,0,198,198,120
0,0,0,0,0,98,195,83,0,0,0,0,0,0,120,0,0
0,0,0,0,0,0,100,689,198,198,198,198,198,198,120,0,0
0,0,0,0,0,0,0,0,0,0,0,0,0,0,0,0,0
