0,0,0,0,0,0,0,0,0,166,0,0,0,0,0,0,0,0,0,0,0,0,0
0,0,0,0,0,0,0,0,0,783,138,0,0,0,0,0,0,0,0,0,0,0,0
0,0,0,0,0,0,0,0,0,0,139,140,167,0,0,0,0,0,0,0,0,0,0
0,0,0,0,0,0,0,0,0,0,0,141,142,168,0,0,0,0,0,0,0,0,0
0,0,0,0,0,71,3,3,3,3,6,3,169,0,245,3,6,3,6,3,0,0,0
0,0,0,0,0,71,10,0,784,0,0,0,0,0,0,0,0,0,0,0,0,0,0
0,0,0,0,0,71,10,0,785,786,0,0,0,0,784,0,0,0,0,0,0,0,0
0,0,77,0,0,71,10,0,0,787,788,0,0,0,785,786,0,0,0,0,0,0,0
0,0,78,79,80,71,10,0,0,0,789,790,0,0,0,787,788,0,0,0,0,0,0
0,0,0,81,82,83,10,0,0,0,0,0,0,0,0,0,789,790,0,0,0,0,0
0,0,0,0,85,86,87,0,0,0,0,0,0,0,0,0,0,0,0,0,0,0,0
0,0,0,0,88,0,0,784,0,0,0,0,0,0,0,0,0,0,0,0,0,0,203
0,0,0,0,185,89,0,785,786,0,0,0,0,784,0,0,0,0,0,0,0,0,203
0,0,0,0,0,71,186,0,787,788,0,0,0,785,786,0,0,0,0,0,0,0,0
0,0,0,0,0,71,10,0,0,789,790,0,0,0,787,788,0,0,0,0,0,0,0
0,0,0,0,0,71,10,0,0,0,0,0,0,0,0,789,790,0,0,0,0,0,0
0,0,0,0,0,71,10,0,0,0,0,0,0,0,0,0,0,0,0,0,0,0,0
0,0,0,0,0,71,10,0,0,0,0,0,0,0,0,0,0,0,0,0,0,0,0
0,0,0,0,0,0,10,0,0,0,0,0,0,0,0,0,0,0,0,0,0,0,0
0,0,0,0,0,0,0,0,0,0,0,0,0,0,0,0,0,0,0,0,0,0,0
