0,1,1,0,0,0,0,0,0,0,0
0,2,0,0,0,0,0,0,0,0,0
0,2,0,0,0,0,0,0,0,0,0
0,2,0,0,0,0,0,0,0,0,0
0,2,0,10,0,0,0,0,0,0,0
0,2,0,0,0,0,0,0,0,0,0
0,2,0,10,0,0,8,0,69,1,0
0,2,0,0,0,0,0,0,70,70,9
0,2,0,10,0,0,0,8,9,0,0
0,2,0,0,0,0,0,0,9,0,0
0,2,0,10,0,0,0,8,9,0,0
0,2,0,0,0,0,0,0,9,0,0
0,2,24,0,0,0,0,7,9,0,0
0,0,24,25,0,0,0,0,0,0,0
0,0,0,25,0,0,0,0,0,9,0
0,0,0,0,0,0,0,0,944,9,0
0,0,0,0,0,0,0,0,945,508,0
0,0,0,0,0,0,0,0,0,508,127
0,0,0,0,0,0,0,70,70,9,0
0,0,0,0,0,0,0,0,0,0,0
