0,0,0,0,0,0,0,0,0,0,0,0,0,0,0,0,0,0,0,0,0,0,0,0,0,0,0,0,0,0,0,0,0,0,0,0,0,0,0,0,0,0,0,0,0,0,0,0,0,0,0,0,0,0,0,0,0
0,0,0,0,0,0,0,0,0,0,0,0,0,0,0,0,0,0,0,0,0,0,0,0,0,0,0,0,0,0,0,0,0,0,0,0,0,0,0,0,0,0,0,0,0,0,0,0,0,0,69,861,0,0,0,0,0
0,0,0,0,0,0,0,0,0,0,0,0,0,0,0,0,0,0,0,0,0,0,0,0,0,0,0,0,0,0,0,0,0,0,0,0,0,0,0,0,0,0,0,0,0,0,0,0,0,69,69,862,863,0,0,0,0
0,0,0,0,0,0,0,0,0,0,0,0,0,0,0,0,0,0,0,0,0,0,0,0,0,0,0,0,0,0,0,0,0,0,0,0,0,0,0,0,0,0,0,0,0,0,0,0,69,69,69,69,69,69,0,0,0
0,0,0,0,0,0,0,0,0,0,0,0,0,0,0,0,0,0,0,0,0,0,0,0,0,0,0,0,0,0,0,0,0,0,0,0,0,0,0,0,0,0,0,0,0,0,0,69,861,69,69,779,69,69,861,0,0
0,0,0,0,0,0,0,0,0,0,0,0,0,0,0,0,0,0,0,0,0,0,0,0,0,0,0,0,0,0,0,0,0,0,0,0,0,0,0,0,0,0,0,0,0,0,0,0,862,863,69,721,780,69,862,863,0
0,0,0,0,0,0,0,0,0,0,0,0,0,0,0,0,0,0,0,0,0,0,0,0,0,0,0,0,0,0,0,0,0,0,0,0,0,0,0,0,0,0,0,0,0,0,0,0,0,69,69,382,69,69,69,69,0
0,0,0,0,0,0,0,0,0,0,0,0,0,0,0,0,0,0,0,0,0,0,0,0,0,0,0,0,0,0,0,0,0,0,0,0,0,0,0,0,0,0,0,0,0,0,0,0,0,0,69,861,523,69,69,0,0
0,0,0,0,0,0,0,0,0,0,0,0,0,0,0,0,0,0,0,0,0,0,0,0,0,0,0,0,0,0,0,0,0,0,0,0,0,0,0,0,0,0,0,0,0,0,0,0,0,0,0,862,863,69,0,0,0
0,0,0,0,0,0,0,0,0,0,0,0,0,0,0,0,0,0,0,0,0,0,0,0,0,0,0,0,0,0,0,0,0,0,0,0,0,0,0,0,0,0,0,0,0,0,0,0,0,0,0,0,69,0,0,0,0
0,0,0,0,0,0,0,0,0,0,0,0,0,0,0,0,0,0,0,0,0,0,0,0,0,0,0,0,0,0,0,0,0,0,0,0,0,0,0,0,0,0,0,0,0,0,0,0,0,0,0,0,0,0,0,0,0
0,0,0,0,0,0,0,0,0,0,0,0,0,0,0,0,0,0,0,0,0,0,0,0,0,0,0,0,0,0,0,0,0,0,0,0,0,0,0,0,0,0,0,0,0,0,0,0,0,0,0,0,0,0,0,0,0
0,0,0,0,0,0,0,0,0,0,0,0,0,0,0,0,0,0,0,0,0,0,0,0,0,475,0,0,475,0,0,475,0,475,60,475,0,0,475,0,0,475,0,0,0,0,0,0,0,0,0,0,0,0,0,0,0
0,0,0,0,0,0,0,0,0,0,0,0,0,0,0,0,0,475,0,0,0,0,0,475,0,0,419,475,475,419,60,475,419,60,419,61,151,60,475,419,60,475,419,60,0,0,0,0,0,0,0,0,0,0,0,0,0
0,0,0,0,0,0,0,0,0,0,0,0,0,0,0,475,0,475,419,475,475,475,0,0,419,475,475,420,151,151,420,61,151,420,61,420,161,312,61,151,420,61,151,420,61,475,0,0,0,0,0,0,0,0,0,0,0
0,0,0,0,0,0,0,0,0,0,0,0,0,0,0,475,419,475,419,420,419,419,419,475,0,420,419,419,13,420,420,13,62,420,13,62,13,0,0,62,420,13,62,420,13,62,151,0,0,0,0,0,0,0,0,0,0
0,0,0,0,0,0,0,0,0,0,0,0,0,0,5,5,419,529,419,420,13,529,420,529,419,475,13,529,420,62,164,164,62,63,164,62,63,62,0,0,63,164,62,63,164,62,63,722,0,0,0,0,0,0,0,0,0
0,0,0,0,0,0,0,0,0,0,0,0,0,0,5,120,120,420,349,420,421,349,339,13,349,420,419,349,339,13,659,531,531,478,423,531,478,423,478,0,0,423,531,478,423,531,478,423,531,0,0,0,0,0,0,0,0
0,0,0,0,0,0,0,0,0,0,0,0,0,5,0,120,9,9,13,421,13,660,421,349,62,421,13,529,421,349,62,659,395,395,395,395,395,395,395,395,69,69,395,395,395,395,395,395,395,352,0,0,0,0,0,0,0
0,0,0,0,0,0,0,0,0,0,0,0,0,0,120,5,9,9,9,864,864,62,421,659,421,659,660,62,349,659,421,659,71,69,69,69,69,69,69,69,865,69,69,69,69,69,69,69,69,0,0,0,0,0,0,0,0
0,0,0,0,0,0,0,0,0,0,0,0,0,5,5,9,120,9,9,866,867,867,868,868,868,868,868,869,868,869,868,868,71,69,861,69,69,69,69,69,870,871,69,69,69,69,861,69,69,0,0,0,0,0,0,0,0
0,0,0,0,0,0,0,0,0,0,0,0,0,5,120,120,9,9,9,866,723,724,724,724,724,724,724,724,724,724,724,724,872,69,862,863,69,69,69,69,69,69,69,69,69,69,862,863,69,0,0,0,0,0,0,0,0
0,0,0,0,0,0,0,0,0,0,0,0,0,0,120,873,874,874,874,874,875,876,724,724,724,724,724,724,724,724,724,877,878,69,69,69,69,69,69,69,69,69,69,69,69,69,69,69,69,0,0,0,0,0,0,0,0
0,0,0,0,0,0,0,0,0,0,0,0,0,5,5,873,524,69,69,69,69,614,9,724,724,724,724,724,724,724,877,725,878,69,69,69,69,69,69,69,861,69,69,69,69,69,69,69,69,0,0,0,0,0,0,0,0
0,0,0,0,0,0,0,0,0,0,0,0,0,5,120,879,524,69,69,69,69,614,9,9,724,724,724,724,724,877,725,725,71,69,69,69,69,69,69,69,862,863,69,69,69,69,69,69,69,0,0,0,0,0,0,0,0
0,0,0,0,0,0,0,0,0,0,0,0,0,0,120,873,524,69,69,69,69,614,9,212,880,724,724,724,877,725,725,881,532,69,69,69,69,69,69,69,69,69,69,69,69,69,69,69,69,0,0,0,0,0,0,0,0
0,0,0,0,0,0,0,0,0,0,0,0,5,5,5,873,524,69,69,69,69,614,9,212,882,874,883,883,725,725,881,532,69,865,69,69,69,861,69,69,69,69,69,861,69,69,69,865,69,0,0,0,0,0,0,0,0
0,0,0,0,0,0,0,0,0,0,0,0,0,120,120,879,884,604,604,604,604,885,9,212,604,604,604,604,604,604,427,69,69,870,871,69,69,862,863,69,69,69,69,862,863,69,69,870,871,618,0,0,0,0,0,0,0
0,0,0,0,0,0,0,0,0,0,0,0,0,5,9,9,726,533,533,533,726,533,9,212,479,533,533,533,533,533,533,886,69,69,69,69,69,69,69,69,382,69,69,69,69,69,69,69,69,0,0,0,0,0,0,0,0
0,0,0,0,0,0,0,0,0,0,0,0,0,5,120,9,9,13,349,339,349,13,339,9,533,9,64,64,64,64,64,533,524,69,69,69,69,69,69,69,861,523,69,69,69,69,69,69,69,0,0,0,0,0,0,0,0
0,0,0,0,0,0,0,0,0,0,0,0,0,0,120,9,9,9,339,13,339,13,339,349,9,64,887,888,889,889,889,889,524,69,69,69,69,69,69,69,862,863,69,69,69,69,69,69,69,0,0,0,0,0,0,0,0
0,0,0,0,0,0,0,0,0,0,0,0,0,0,5,9,9,9,9,64,64,64,64,64,70,887,888,742,725,725,725,725,524,69,69,69,69,69,69,69,69,69,69,69,69,69,69,69,69,0,0,0,0,0,0,0,0
0,0,0,0,0,0,0,0,0,0,0,0,0,0,0,120,9,9,9,890,888,888,888,888,888,888,891,725,725,725,725,725,524,69,861,69,69,69,69,69,69,69,69,69,69,69,861,69,69,0,0,0,0,0,0,0,0
0,0,0,0,0,0,0,0,0,0,0,0,0,0,0,5,9,9,9,890,891,704,704,704,704,704,704,704,725,725,725,725,524,69,862,863,69,69,69,69,865,69,69,69,69,69,862,863,69,0,0,0,0,0,0,0,0
0,0,0,0,0,0,0,0,0,0,0,0,0,0,0,0,120,9,9,890,891,704,704,704,704,704,704,704,704,725,725,725,524,69,69,69,69,69,69,69,870,871,69,69,69,69,69,69,69,0,0,0,0,0,0,0,0
0,0,0,0,0,0,0,0,0,0,0,0,0,0,0,0,0,9,9,890,891,704,704,704,704,704,704,704,704,704,725,725,892,16,16,16,16,16,16,16,69,16,16,16,16,16,16,16,16,0,0,0,0,0,0,0,0
0,0,0,0,0,0,0,0,0,0,0,0,0,0,0,0,0,0,9,890,891,704,704,704,704,704,704,704,704,704,704,725,893,0,0,0,0,0,0,0,0,0,0,0,0,0,0,0,0,0,0,0,0,0,0,0,0
0,0,0,0,0,0,0,0,0,0,0,0,0,0,0,0,0,0,0,890,891,704,704,704,704,704,704,704,704,704,704,704,725,0,0,0,0,0,0,0,0,0,0,0,0,0,0,0,0,0,0,0,0,0,0,0,0
0,0,0,0,0,0,0,0,0,0,0,0,0,0,0,0,0,0,0,0,727,727,727,727,727,727,727,727,727,727,727,727,727,727,0,0,0,0,0,0,0,0,0,0,0,0,0,0,0,0,0,0,0,0,0,0,0
0,0,0,0,0,0,0,0,0,0,0,0,0,0,0,0,0,0,0,0,0,728,728,728,728,728,728,728,728,728,728,728,728,728,728,0,0,0,0,0,0,0,0,0,0,0,0,0,0,0,0,0,0,0,0,0,0
