0,0,0,0,142,143,1,477,1,0,0,0,0,0,0,0
0,0,0,0,7,144,145,3,478,3,0,0,0,0,0,0
0,0,0,1,0,492,846,148,454,479,290,0,0,0,0,0
0,0,7,0,3,516,493,494,0,457,110,495,0,0,0,0
0,0,245,0,0,0,558,326,483,0,198,181,61,0,0,0
0,0,159,247,0,455,456,0,327,297,111,200,183,113,0,0
0,0,0,160,0,459,460,461,0,329,112,115,0,64,26,0
0,0,0,0,0,75,76,462,557,370,114,0,114,29,29,21
0,0,0,0,0,496,497,465,498,372,373,115,0,21,0,0
0,0,0,0,0,0,499,468,847,118,29,29,29,21,0,0
0,0,0,0,0,0,0,0,0,0,0,0,0,0,0,0
