94,95,35,36,37,38,35,36,37,38,35,36,37,38,35,0,0,0,0,0,0,0,0
39,96,97,16,14,40,15,16,14,40,174,16,14,40,15,16,0,0,0,0,0,0,0
41,26,27,42,17,18,19,42,17,18,19,42,17,18,19,42,17,0,0,0,0,0,0
43,20,28,20,14,40,15,16,14,218,15,175,14,21,15,16,14,21,0,0,0,0,0
44,22,23,22,176,183,187,188,100,46,219,177,52,46,47,99,100,46,47,0,0,0,0
39,24,25,24,48,994,424,49,49,49,49,49,52,52,49,49,49,49,49,189,0,0,0
41,26,27,26,102,103,52,52,52,52,52,52,52,52,52,52,52,52,52,58,0,0,0
43,20,28,20,106,179,52,52,52,52,52,52,52,52,52,52,52,52,52,58,0,0,0
44,22,23,22,45,995,52,52,52,52,52,52,52,52,52,52,52,52,52,58,0,0,0
39,24,25,24,48,996,52,52,52,52,251,52,52,52,52,52,52,52,52,58,0,0,0
41,26,27,26,55,53,52,52,52,52,52,52,52,52,52,52,52,52,52,58,0,0,0
43,20,28,20,48,181,52,52,52,52,52,52,52,52,52,52,52,52,52,52,210,211,0
44,22,23,22,45,103,52,52,52,52,425,52,52,52,52,52,52,52,52,52,190,212,0
39,24,25,24,48,996,52,52,52,52,52,425,52,52,52,52,52,52,52,58,213,214,0
0,26,27,26,55,997,52,52,52,52,52,52,52,52,52,52,52,52,52,58,0,0,0
0,0,28,20,48,181,52,52,52,52,52,52,52,52,52,52,52,52,52,58,0,0,0
0,0,0,22,45,103,52,52,52,52,52,52,52,52,52,52,52,52,52,58,0,0,0
0,0,0,0,48,996,52,52,52,52,52,52,52,52,52,52,52,52,52,58,0,0,0
0,0,0,0,0,997,52,52,52,52,52,52,52,52,52,52,52,52,52,58,0,0,0
0,0,0,0,0,0,60,60,60,60,60,60,60,60,60,60,60,60,60,60,0,0,0
