0,0,0,0,0,0,0,0,0,0,0,0,0,0,0,0,0,0,0,0,0,0,0
32,33,34,34,34,34,33,34,34,33,34,34,34,34,33,0,0,0,0,0,0,0,0
37,38,39,40,40,40,40,39,40,40,39,40,40,40,40,39,0,0,0,0,0,0,0
37,43,44,45,46,133,133,46,45,46,46,45,46,133,133,46,45,0,0,0,0,0,0
37,43,50,44,45,46,134,134,46,45,46,46,45,46,134,134,46,45,0,0,0,0,0
37,43,50,50,53,54,55,55,55,55,54,55,55,54,55,55,55,55,54,0,0,0,0
32,43,50,50,58,67,61,59,60,60,59,159,59,59,61,59,59,59,59,61,0,0,0
37,38,50,50,58,65,49,57,57,57,57,57,56,49,57,49,49,49,57,49,0,0,0
37,43,44,50,58,65,57,49,52,49,49,57,63,63,57,49,68,57,63,57,0,0,0
32,43,50,94,58,65,57,49,49,56,57,49,66,66,49,49,57,56,63,57,0,0,0
37,38,50,50,95,65,49,57,49,57,49,49,57,57,63,63,57,49,57,57,0,0,0
37,43,44,50,58,67,49,49,63,63,63,57,57,49,57,57,63,57,49,57,0,0,0
37,43,50,94,58,65,63,63,57,57,63,57,49,49,68,49,66,49,49,49,49,49,0
37,43,50,50,95,65,57,57,57,49,57,57,49,57,49,56,63,63,57,49,63,57,0
32,43,50,50,58,67,49,49,49,57,49,49,57,49,57,49,63,57,57,49,62,62,0
0,38,50,50,58,65,52,49,63,57,49,49,49,49,49,57,66,49,57,49,0,0,0
0,0,44,50,58,65,49,56,66,49,57,49,63,57,49,49,66,49,63,57,0,0,0
0,0,0,44,58,65,49,49,57,57,68,57,57,63,63,57,57,57,57,57,0,0,0
0,0,0,0,53,65,57,49,49,57,49,56,49,57,57,57,49,52,49,49,0,0,0
0,0,0,0,0,67,49,63,63,57,49,49,57,49,49,57,49,49,184,57,0,0,0
0,0,0,0,0,0,62,62,62,62,62,62,62,62,62,62,62,62,62,62,0,0,0
