0,1,1,5,1,1,0,0,0,0,0,0
0,24,0,0,6,0,0,0,0,0,0,0
0,24,25,0,88,89,90,0,0,0,0,0
0,2,25,0,0,96,91,97,0,0,0,0
0,2,0,10,0,0,0,0,0,0,0,0
0,2,0,0,0,0,0,0,0,0,0,0
0,24,0,0,0,92,0,8,0,0,93,9
0,24,25,10,0,0,979,0,0,0,0,9
0,0,25,0,0,0,8,99,0,8,0,9
0,0,0,0,0,0,138,93,7,0,0,9
0,0,0,0,0,0,8,139,0,0,0,9
0,0,0,0,0,0,0,0,0,0,8,9
0,0,0,0,0,0,70,86,0,70,70,9
0,0,0,0,0,0,0,0,2,9,0,0
0,0,0,0,0,0,0,0,94,9,0,0
0,0,0,0,0,0,0,0,0,0,0,0
