355,355,355,355,355,355,355,355,355,355,355,355,355,355,355,355,355,355,355,355,355,355,355,355,355,355,355,355,355,355,355,355,355,355,355,355,355,355,355,355,355,355,355,355,355,355,355
355,355,355,355,355,355,355,355,355,355,355,355,355,355,355,355,355,355,355,355,355,355,355,355,355,355,355,355,355,355,355,355,355,355,355,355,355,355,355,355,355,355,355,355,355,355,355
355,355,355,355,355,355,355,355,355,355,355,355,355,355,355,355,355,355,355,355,355,355,355,355,355,355,355,355,355,355,355,355,355,355,355,355,355,355,355,355,355,355,355,355,355,355,355
355,355,355,355,355,355,355,355,355,355,355,355,355,355,355,355,355,355,355,355,355,355,355,355,355,355,355,355,355,355,355,355,355,355,355,355,355,355,355,355,355,355,355,355,355,355,355
355,355,355,355,355,355,355,355,355,355,355,355,355,355,355,355,355,355,355,355,355,355,355,355,355,355,355,355,355,607,355,355,355,355,355,355,355,355,355,355,355,355,355,355,355,355,355
355,355,355,355,355,355,355,355,355,355,355,355,355,355,355,355,355,355,355,355,355,355,355,355,355,355,355,355,608,609,610,355,355,355,355,355,355,355,355,355,355,355,355,355,355,355,355
355,355,355,355,355,355,355,355,355,355,355,355,355,355,355,355,355,355,355,355,355,355,355,355,355,607,355,355,611,610,610,612,355,355,355,355,355,355,355,355,355,355,355,355,355,355,355
355,355,355,355,355,355,355,355,355,355,355,355,355,355,355,355,355,355,355,355,355,355,355,355,608,609,610,355,355,613,610,610,610,355,355,355,355,355,355,355,355,355,355,355,355,355,355
355,355,355,355,355,355,355,355,355,355,355,355,355,355,355,355,355,355,355,355,355,355,355,355,611,610,610,612,355,355,610,610,614,615,355,355,355,355,355,355,355,355,355,355,355,355,355
355,355,355,355,355,355,355,355,355,355,355,355,355,355,355,355,355,355,355,355,355,355,355,355,355,613,610,610,610,355,355,616,617,618,619,355,355,355,355,355,355,355,355,355,355,355,355
355,355,355,355,355,355,355,355,355,355,355,355,355,355,355,355,355,355,355,355,355,355,355,355,355,355,610,610,614,615,355,355,620,610,610,355,355,355,355,355,355,355,355,355,355,355,355
355,355,355,355,355,355,355,355,355,355,355,355,355,355,355,355,355,355,355,355,355,355,355,355,355,355,355,616,617,618,619,355,355,610,610,355,355,355,355,355,355,355,355,355,355,355,355
355,355,355,355,355,355,355,355,355,355,355,355,355,355,355,355,355,355,355,355,355,355,355,355,355,355,355,355,620,610,610,355,355,355,610,355,355,355,355,355,355,355,355,355,355,355,355
355,355,355,355,355,355,355,355,355,355,355,355,355,355,355,355,355,355,355,355,355,355,355,355,355,355,355,355,355,610,610,355,355,355,355,355,355,355,355,355,355,355,355,355,355,355,355
355,355,355,355,355,355,355,355,355,355,355,355,355,355,355,355,355,355,355,355,355,355,355,355,355,355,355,355,355,355,610,355,355,355,355,355,355,355,355,355,355,355,355,355,355,355,355
355,355,355,355,355,355,355,355,355,355,355,355,355,355,355,355,355,355,355,355,355,355,355,355,355,355,355,355,355,355,355,355,355,355,355,355,355,355,355,355,355,355,355,355,355,355,355
355,355,355,355,355,355,355,355,355,355,355,355,355,355,355,355,355,355,355,355,355,355,355,355,355,355,355,355,355,355,355,355,355,355,355,355,355,355,355,355,355,607,355,355,355,355,355
355,355,355,355,355,355,355,355,355,355,355,355,355,355,355,355,621,355,355,355,355,355,355,355,355,355,355,355,355,355,355,355,355,355,355,355,355,355,355,355,608,609,610,355,355,355,355
355,355,355,355,355,355,355,355,355,355,355,355,355,355,355,622,623,624,625,355,355,355,355,355,355,355,355,355,355,355,355,355,355,355,355,355,355,355,355,355,611,610,610,612,355,355,355
355,355,355,355,355,355,355,355,355,355,355,355,355,607,626,627,628,629,630,631,632,355,355,355,355,355,355,355,355,355,355,355,355,355,355,355,355,355,607,355,355,613,610,610,610,355,355
355,355,355,355,355,355,355,355,355,355,355,355,608,609,610,633,634,635,636,637,638,639,355,355,355,355,355,355,355,355,355,355,355,355,355,355,355,608,609,610,355,355,610,610,614,615,355
355,355,355,355,355,355,355,355,355,355,355,355,611,610,610,612,640,641,610,642,620,643,355,355,355,355,355,355,355,355,355,355,355,355,355,355,355,611,610,610,612,355,355,616,617,618,619
355,355,355,355,355,355,355,355,355,355,355,644,645,613,610,610,610,646,647,610,648,649,650,355,355,355,355,355,355,355,355,355,355,355,355,355,355,355,613,610,610,610,355,355,620,610,610
355,355,355,355,355,355,355,355,355,355,651,652,653,654,610,610,614,615,655,656,657,658,659,355,355,355,355,355,355,355,355,355,355,355,355,355,355,355,355,610,610,614,615,355,355,610,610
355,355,355,355,355,355,355,355,355,355,660,661,662,663,664,616,617,618,619,665,666,667,668,669,355,355,355,355,355,355,355,355,355,355,355,355,355,355,355,355,616,617,618,619,355,355,610
355,355,355,355,355,355,355,355,355,355,355,670,671,672,673,674,620,610,610,610,675,676,677,355,355,355,355,355,355,355,355,355,355,355,355,355,355,355,355,355,355,620,610,610,355,355,355
355,355,355,355,355,355,355,355,355,355,355,678,679,679,680,681,682,610,610,610,610,683,355,355,355,355,355,355,355,355,355,355,355,355,355,355,355,355,355,355,355,355,610,610,355,355,355
355,355,355,355,355,355,355,355,355,355,355,684,685,686,687,688,689,690,691,610,692,693,355,355,355,355,355,355,355,355,355,355,355,355,355,355,355,355,355,355,355,355,355,610,355,355,355
355,355,355,355,355,355,355,355,355,355,355,355,694,695,696,657,697,698,699,700,701,355,355,355,355,355,355,355,355,355,355,355,355,355,355,355,355,355,355,355,355,355,355,355,355,355,355
355,355,355,355,355,355,355,355,355,355,355,355,355,702,703,704,705,706,707,355,355,355,355,355,355,355,355,355,355,355,355,355,355,355,355,355,355,355,355,355,355,355,355,355,355,355,355
355,355,355,355,355,355,355,355,355,355,355,355,355,355,355,355,708,709,355,355,355,355,355,355,355,355,355,355,355,355,355,355,355,355,355,355,355,355,355,355,355,355,355,355,355,355,355
