0,0,1,1,0,0,0,1,0,0,0,0,0,0,0,0
0,0,374,3,3,92,146,393,412,0,0,0,0,0,0,0
0,0,375,376,0,0,357,93,396,396,176,0,0,0,0,0
0,0,0,377,9,358,359,323,72,149,0,667,0,0,0,0
0,0,0,0,0,360,361,668,0,59,272,0,416,0,0,0
0,0,7,0,0,362,363,364,77,0,60,324,0,21,0,0
0,0,7,398,218,669,365,366,670,79,0,0,0,64,26,0
0,0,0,0,400,367,61,368,342,339,0,0,0,29,29,21
0,0,0,0,0,62,369,113,370,0,0,0,0,21,0,0
0,0,0,0,0,371,63,113,372,373,0,0,0,21,0,0
0,0,0,0,0,0,671,29,29,29,29,29,29,21,0,0
0,0,0,0,0,0,0,0,0,0,0,0,0,0,0,0
