0,0,0,0,0,0,0,0,0,0,0,0
19,5,6,7,10,5,6,15,0,0,0,0
65,83,8,44,9,6,8,44,18,0,0,0
14,84,25,7,22,5,21,7,22,15,0,0
16,17,85,86,10,8,22,9,0,8,18,0
19,20,81,89,90,6,10,8,7,291,10,15
65,83,23,24,33,92,29,28,29,288,347,30
14,84,25,26,27,24,13,12,13,13,13,34
16,17,85,86,20,87,13,13,31,13,13,32
39,20,81,89,90,91,13,13,13,13,13,32
0,40,23,24,33,92,12,13,13,13,13,32
0,0,41,26,27,24,13,31,13,13,13,32
0,0,0,40,20,87,13,13,13,13,12,32
0,0,0,0,41,91,13,13,13,13,13,34
0,0,0,0,0,42,43,43,43,43,43,43
